rank,college,conf,year,coach,school,other,total,max,prior year bonus
1,Alabama,SEC,2018,Nick Saban,8307000,0,8307000,1100000,500000
1,Alabama,SEC,2017,Nick Saban,11132000,0,11132000,700000,550000
1,Alabama,SEC,2016,Nick Saban,6939395,0,6939395,700000,625000
1,Alabama,SEC,2015,Nick Saban,6932395,155086,7087481,700000,425000
1,Alabama,SEC,2014,Nick Saban,6950203,209984,7160187,700000,0
1,Alabama,SEC,2013,Nick Saban,5395852,150000,5545852,700000,0
1,Alabama,SEC,2012,Nick Saban,5316667,160071,5476738,700000,0
1,Alabama,SEC,2011,Nick Saban,4683333,150000,4833333,700000,0
1,Alabama,SEC,2010,Nick Saban,5166666,830683,5997349,700000,0
1,Alabama,SEC,2009,Nick Saban,225000,3675000,3900000,700000,0
1,Alabama,SEC,2007,Nick Saban,225000,3278200,3503200,700000,0
1,Alabama,SEC,2006,Mike Shula,412000,1354853,1766853,875000,0
2,Ohio State,Big Ten,2018,Urban Meyer,7600000,0,7600000,775000,350000
2,Ohio State,Big Ten,2017,Urban Meyer,6431240,0,6431240,775000,300000
2,Ohio State,Big Ten,2016,Urban Meyer,6003000,91800,6094800,775000,250000
2,Ohio State,Big Ten,2015,Urban Meyer,5860000,0,5860000,775000,400000
2,Ohio State,Big Ten,2014,Urban Meyer,4486640,50000,4536640,550000,0
2,Ohio State,Big Ten,2013,Urban Meyer,4608000,0,4608000,550000,0
2,Ohio State,Big Ten,2012,Urban Meyer,4250000,50000,4300000,450000,0
2,Ohio State,Big Ten,2011,Luke Fickell,1172000,0,1172000,150000,0
2,Ohio State,Big Ten,2010,Jim Tressel,3512000,376389,3888389,450000,0
2,Ohio State,Big Ten,2009,Jim Tressel,1065000,2657000,3722000,450000,0
2,Ohio State,Big Ten,2007,Jim Tressel,965000,1402000,2367000,450000,0
2,Ohio State,Big Ten,2006,Jim Tressel,890000,1122700,2012700,375000,0
3,Michigan,Big Ten,2018,Jim Harbaugh,7504000,0,7504000,1325000,150000
3,Michigan,Big Ten,2017,Jim Harbaugh,7004000,0,7004000,1325000,200000
3,Michigan,Big Ten,2016,Jim Harbaugh,9004000,0,9004000,1325000,0
3,Michigan,Big Ten,2015,Jim Harbaugh,7004000,0,7004000,1175000,0
3,Michigan,Big Ten,2014,Brady Hoke,2854000,2000,2856000,575000,0
3,Michigan,Big Ten,2013,Brady Hoke,4154000,0,4154000,550000,0
3,Michigan,Big Ten,2012,Brady Hoke,3046120,0,3046120,525000,0
3,Michigan,Big Ten,2011,Brady Hoke,3254000,0,3254000,500000,0
3,Michigan,Big Ten,2010,Rich Rodriguez,2515180,10100,2525280,300000,0
3,Michigan,Big Ten,2009,Rich Rodriguez,859000,1662000,2521000,300000,0
3,Michigan,Big Ten,2007,Lloyd Carr,687884,795000,1482884,64648,0
3,Michigan,Big Ten,2006,Lloyd Carr,647619,807000,1454619,84373,0
4,Texas A&M,SEC,2018,Jimbo Fisher,7500000,0,7500000,1350000,0
4,Texas A&M,SEC,2017,Kevin Sumlin,5000000,0,5000000,1050000,100000
4,Texas A&M,SEC,2016,Kevin Sumlin,5000000,0,5000000,1350000,50000
4,Texas A&M,SEC,2015,Kevin Sumlin,5000000,0,5000000,1350000,50000
4,Texas A&M,SEC,2014,Kevin Sumlin,5000000,6000,5006000,750000,0
4,Texas A&M,SEC,2013,Kevin Sumlin,3100000,300,3100300,750000,0
4,Texas A&M,SEC,2012,Kevin Sumlin,2436000,300,2436300,625000,0
4,Texas A&M,SEC,2011,Mike Sherman,2200000,1000,2201000,350000,0
4,Texas A&M,SEC,2010,Mike Sherman,1800000,1000,1801000,350000,0
4,Texas A&M,SEC,2009,Mike Sherman,500001,1301650,1801651,350000,0
4,Texas A&M,SEC,2007,Dennis Franchione,527000,1547216,2074216,350000,0
4,Texas A&M,SEC,2006,Dennis Franchione,512000,1507700,2019700,350000,0
7,Clemson,ACC,2018,Dabo Swinney,6205000,338350,6543350,1125000,500000
7,Clemson,ACC,2017,Dabo Swinney,8504600,22200,8526800,1000000,1525000
7,Clemson,ACC,2016,Dabo Swinney,4417500,5200,4422700,1725000,1100000
7,Clemson,ACC,2015,Dabo Swinney,3300000,5200,3305200,1125000,50000
7,Clemson,ACC,2014,Dabo Swinney,3150000,25100,3175100,1200000,0
7,Clemson,ACC,2013,Dabo Swinney,2540024,10000,2550024,775000,0
7,Clemson,ACC,2012,Dabo Swinney,2040024,10000,2050024,775000,0
7,Clemson,ACC,2011,Dabo Swinney,1833333,13000,1846333,775000,0
7,Clemson,ACC,2010,Dabo Swinney,1750000,18500,1768500,694792,0
7,Clemson,ACC,2009,Dabo Swinney,250000,566850,816850,875000,0
7,Clemson,ACC,2007,Tommy Bowden,297332,934500,1231832,272278,0
7,Clemson,ACC,2006,Tommy Bowden,273028,925000,1198028,270252,0
6,Georgia,SEC,2018,Kirby Smart,6603600,0,6603600,1150000,1350000
6,Georgia,SEC,2017,Kirby Smart,3753600,0,3753600,1800000,75000
6,Georgia,SEC,2016,Kirby Smart,3753600,0,3753600,1800000,0
6,Georgia,SEC,2015,Mark Richt,4000000,124000,4124000,1800000,75000
6,Georgia,SEC,2014,Mark Richt,3200000,114000,3314000,1000000,0
6,Georgia,SEC,2013,Mark Richt,3200000,114000,3314000,1000000,0
6,Georgia,SEC,2012,Mark Richt,2811340,114000,2925340,1000000,0
6,Georgia,SEC,2011,Mark Richt,2811400,128400,2939800,525000,0
6,Georgia,SEC,2010,Mark Richt,2811340,126400,2937740,600000,0
6,Georgia,SEC,2009,Mark Richt,809340,2287236,3096576,475000,0
6,Georgia,SEC,2007,Mark Richt,578100,1446600,2024700,400000,0
6,Georgia,SEC,2006,Mark Richt,270000,1443000,1713000,400000,0
10,Nebraska,Big Ten,2018,Scott Frost,5000000,0,5000000,950000,0
10,Nebraska,Big Ten,2017,Mike Riley,2900000,0,2900000,950000,150000
10,Nebraska,Big Ten,2016,Mike Riley,2800000,0,2800000,950000,0
10,Nebraska,Big Ten,2015,Mike Riley,2700000,0,2700000,950000,0
10,Nebraska,Big Ten,2014,Bo Pelini,3077646,0,3077646,1000000,0
10,Nebraska,Big Ten,2013,Bo Pelini,2975000,0,2975000,1000000,0
10,Nebraska,Big Ten,2012,Bo Pelini,2875000,0,2875000,1000000,0
10,Nebraska,Big Ten,2011,Bo Pelini,2775000,0,2775000,1000000,0
10,Nebraska,Big Ten,2010,Bo Pelini,2100000,0,2100000,550000,0
10,Nebraska,Big Ten,2009,Bo Pelini,1852000,0,1852000,550000,0
10,Nebraska,Big Ten,2007,Bill Callahan,726250,1025000,1751250,425000,0
10,Nebraska,Big Ten,2006,Bill Callahan,1690317,0,1690317,113547,0
11,Oklahoma State,Big 12,2018,Mike Gundy,5000000,0,5000000,900000,62500
11,Oklahoma State,Big 12,2017,Mike Gundy,4200000,0,4200000,900000,62500
11,Oklahoma State,Big 12,2016,Mike Gundy,3775000,0,3775000,550000,100000
11,Oklahoma State,Big 12,2015,Mike Gundy,3650000,0,3650000,550000,62500
11,Oklahoma State,Big 12,2014,Mike Gundy,3500000,0,3500000,550000,0
11,Oklahoma State,Big 12,2013,Mike Gundy,3450000,0,3450000,550000,0
11,Oklahoma State,Big 12,2012,Mike Gundy,3275000,0,3275000,550000,0
11,Oklahoma State,Big 12,2011,Mike Gundy,2100000,0,2100000,500000,0
11,Oklahoma State,Big 12,2010,Mike Gundy,1925000,0,1925000,500000,0
11,Oklahoma State,Big 12,2009,Mike Gundy,375000,1425000,1800000,500000,0
11,Oklahoma State,Big 12,2007,Mike Gundy,275000,675000,950000,684000,0
11,Oklahoma State,Big 12,2006,Mike Gundy,250000,550000,800000,684000,0
12,Florida State,ACC,2018,Willie Taggart,5000000,0,5000000,1475000,0
12,Florida State,ACC,2017,Jimbo Fisher,5700000,0,5700000,1475000,200000
12,Florida State,ACC,2016,Jimbo Fisher,5250000,0,5250000,1475000,100000
12,Florida State,ACC,2015,Jimbo Fisher,5150000,0,5150000,1475000,500000
12,Florida State,ACC,2014,Jimbo Fisher,3591667,0,3591667,1275000,0
12,Florida State,ACC,2013,Jimbo Fisher,2750000,0,2750000,675000,0
12,Florida State,ACC,2012,Jimbo Fisher,2750000,0,2750000,675000,0
12,Florida State,ACC,2011,Jimbo Fisher,2750000,0,2750000,725000,0
12,Florida State,ACC,2010,Jimbo Fisher,1800000,3500,1803500,675000,0
12,Florida State,ACC,2009,Bobby Bowden,565875,1753500,2319375,727793,0
12,Florida State,ACC,2007,Bobby Bowden,478200,1217000,1695200,272578,0
12,Florida State,ACC,2006,Bobby Bowden,352200,1339700,1691900,272578,0
14,Texas Christian,Big 12,2018,Gary Patterson,4840717,0,4840717,0,0
14,Texas Christian,Big 12,2017,Gary Patterson,5104077,0,5104077,0,0
14,Texas Christian,Big 12,2016,Gary Patterson,4014723,0,4014723,0,0
14,Texas Christian,Big 12,2015,Gary Patterson,3940026,0,3940026,0,0
14,Texas Christian,Big 12,2014,Gary Patterson,4008150,0,4008150,0,0
14,Texas Christian,Big 12,2013,Gary Patterson,3120760,0,3120760,0,0
14,Texas Christian,Big 12,2012,Gary Patterson,3467926,0,3467926,0,0
14,Texas Christian,Big 12,2011,Gary Patterson,2018362,0,2018362,0,0
14,Texas Christian,Big 12,2010,Gary Patterson,1642089,0,1642089,0,0
14,Texas Christian,Big 12,2009,Gary Patterson,1800000,0,1800000,0,0
14,Texas Christian,Big 12,2007,Gary Patterson,1219212,0,1219212,0,0
14,Texas Christian,Big 12,2006,Gary Patterson,952162,0,952162,0,0
15,Penn State,Big Ten,2018,James Franklin,4800000,0,4800000,1000000,300000
15,Penn State,Big Ten,2017,James Franklin,4600000,0,4600000,1000000,900000
15,Penn State,Big Ten,2016,James Franklin,4500000,0,4500000,1000000,200000
15,Penn State,Big Ten,2015,James Franklin,4400000,0,4400000,1000000,200000
15,Penn State,Big Ten,2014,James Franklin,4300000,0,4300000,1000000,0
15,Penn State,Big Ten,2013,Bill O'Brien,3282779,0,3282779,200000,0
15,Penn State,Big Ten,2012,Bill O'Brien,2300000,0,2300000,47500,0
15,Penn State,Big Ten,2011,Joe Paterno,1022794,0,1022794,0,0
15,Penn State,Big Ten,2010,Joe Paterno,1109977,0,1109977,0,0
15,Penn State,Big Ten,2009,Joe Paterno,1097767,0,1097767,0,0
15,Penn State,Big Ten,2007,Joe Paterno,512664,0,512664,0,0
15,Penn State,Big Ten,2006,Joe Paterno,0,0,0,0,0
16,Oklahoma,Big 12,2018,Lincoln Riley,4800000,0,4800000,700000,180000
16,Oklahoma,Big 12,2017,Lincoln Riley,2116666,0,2116666,700000,0
16,Oklahoma,Big 12,2016,Bob Stoops,5550000,0,5550000,834000,333000
16,Oklahoma,Big 12,2015,Bob Stoops,5400000,0,5400000,834000,75000
16,Oklahoma,Big 12,2014,Bob Stoops,5058333,0,5058333,819500,0
16,Oklahoma,Big 12,2013,Bob Stoops,4741667,31500,4773167,819500,0
16,Oklahoma,Big 12,2012,Bob Stoops,4550000,0,4550000,819500,0
16,Oklahoma,Big 12,2011,Bob Stoops,4075000,0,4075000,819500,0
16,Oklahoma,Big 12,2010,Bob Stoops,4275000,100000,4375000,819500,0
16,Oklahoma,Big 12,2009,Bob Stoops,1350000,2953000,4303000,819500,0
16,Oklahoma,Big 12,2007,Bob Stoops,970000,2650000,3620000,745000,0
16,Oklahoma,Big 12,2006,Bob Stoops,950000,2500000,3450000,745000,0
18,Michigan State,Big Ten,2018,Mark Dantonio,4390417,0,4390417,650000,125000
18,Michigan State,Big Ten,2017,Mark Dantonio,4380492,10000,4390492,650000,0
18,Michigan State,Big Ten,2016,Mark Dantonio,4300000,0,4300000,650000,475000
18,Michigan State,Big Ten,2015,Mark Dantonio,3671520,0,3671520,650000,250000
18,Michigan State,Big Ten,2014,Mark Dantonio,5611845,24300,5636145,650000,0
18,Michigan State,Big Ten,2013,Mark Dantonio,1959744,0,1959744,650000,0
18,Michigan State,Big Ten,2012,Mark Dantonio,1934250,0,1934250,650000,0
18,Michigan State,Big Ten,2011,Mark Dantonio,1918000,0,1918000,650000,0
18,Michigan State,Big Ten,2010,Mark Dantonio,1796700,0,1796700,660000,0
18,Michigan State,Big Ten,2009,Mark Dantonio,827260,984000,1811260,725000,0
18,Michigan State,Big Ten,2007,Mark Dantonio,600000,550000,1150000,650000,0
18,Michigan State,Big Ten,2006,John L. Smith,645834,900000,1545834,375000,0
19,Washington,Pac-12,2018,Chris Petersen,4375000,2500,4377500,1050000,300000
19,Washington,Pac-12,2017,Chris Petersen,4125000,2500,4127500,1050000,675000
19,Washington,Pac-12,2016,Chris Petersen,3600000,5847,3605847,1175000,150000
19,Washington,Pac-12,2015,Chris Petersen,3400000,2940,3402940,1175000,200000
19,Washington,Pac-12,2014,Chris Petersen,3681720,0,3681720,1175000,0
19,Washington,Pac-12,2013,Steve Sarkisian,2575000,0,2575000,1525000,0
19,Washington,Pac-12,2012,Steve Sarkisian,2425000,0,2425000,1525000,0
19,Washington,Pac-12,2011,Steve Sarkisian,2250000,0,2250000,1075000,0
19,Washington,Pac-12,2010,Steve Sarkisian,1850004,0,1850004,1500000,0
19,Washington,Pac-12,2009,Steve Sarkisian,450000,1383333,1833333,1500000,0
19,Washington,Pac-12,2007,Tyrone Willingham,657472,812804,1470276,337500,0
19,Washington,Pac-12,2006,Tyrone Willingham,664768,750004,1414772,402500,0
20,Stanford,Pac-12,2018,David Shaw,4311543,0,4311543,0,0
20,Stanford,Pac-12,2017,David Shaw,5680441,0,5680441,0,0
20,Stanford,Pac-12,2016,David Shaw,4067219,0,4067219,0,0
20,Stanford,Pac-12,2015,David Shaw,2224435,0,2224435,0,0
20,Stanford,Pac-12,2014,David Shaw,2012666,0,2012666,0,0
20,Stanford,Pac-12,2013,David Shaw,0,0,0,0,0
20,Stanford,Pac-12,2012,David Shaw,0,0,0,0,0
20,Stanford,Pac-12,2011,David Shaw,0,0,0,0,0
20,Stanford,Pac-12,2010,Jim Harbaugh,0,0,0,0,0
20,Stanford,Pac-12,2009,Jim Harbaugh,0,0,0,0,0
20,Stanford,Pac-12,2007,Jim Harbaugh,0,0,0,0,0
20,Stanford,Pac-12,2006,Walt Harris,0,0,0,0,0
21,South Carolina,SEC,2018,Will Muschamp,4200000,0,4200000,1400000,100000
21,South Carolina,SEC,2017,Will Muschamp,3100000,0,3100000,1075000,125000
21,South Carolina,SEC,2016,Will Muschamp,3000000,2500,3002500,1075000,0
21,South Carolina,SEC,2015,Steve Spurrier,4000000,28600,4028600,1700000,200000
21,South Carolina,SEC,2014,Steve Spurrier,4000000,16900,4016900,1700000,0
21,South Carolina,SEC,2013,Steve Spurrier,3300000,22500,3322500,1550000,0
21,South Carolina,SEC,2012,Steve Spurrier,3550000,35000,3585000,1550000,0
21,South Carolina,SEC,2011,Steve Spurrier,2800000,28000,2828000,1000000,0
21,South Carolina,SEC,2010,Steve Spurrier,2000000,32500,2032500,1000000,0
21,South Carolina,SEC,2009,Steve Spurrier,507500,1524000,2031500,900000,0
21,South Carolina,SEC,2007,Steve Spurrier,257500,1515000,1772500,800000,0
21,South Carolina,SEC,2006,Steve Spurrier,257500,1042500,1300000,700000,0
22,Miami (Fla.),ACC,2018,Mark Richt,4058061,0,4058061,0,0
22,Miami (Fla.),ACC,2017,Mark Richt,0,0,0,0,0
22,Miami (Fla.),ACC,2016,Mark Richt,0,0,0,0,0
22,Miami (Fla.),ACC,2015,Al Golden,2539315,0,2539315,0,0
22,Miami (Fla.),ACC,2014,Al Golden,2250943,0,2250943,0,0
22,Miami (Fla.),ACC,2013,Al Golden,2148107,0,2148107,0,0
22,Miami (Fla.),ACC,2012,Al Golden,0,0,0,0,0
22,Miami (Fla.),ACC,2011,Al Golden,0,0,0,0,0
22,Miami (Fla.),ACC,2010,Randy Shannon,0,0,0,0,0
22,Miami (Fla.),ACC,2009,Randy Shannon,0,0,0,0,0
22,Miami (Fla.),ACC,2007,Randy Shannon,0,0,0,0,0
22,Miami (Fla.),ACC,2006,Larry Coker,1800000,0,1800000,0,0
23,Kentucky,SEC,2018,Mark Stoops,4000000,13600,4013600,3100000,300000
23,Kentucky,SEC,2017,Mark Stoops,3750000,13600,3763600,3100000,425000
23,Kentucky,SEC,2016,Mark Stoops,3500000,13600,3513600,2800000,50000
23,Kentucky,SEC,2015,Mark Stoops,3250000,13600,3263600,2775000,125000
23,Kentucky,SEC,2014,Mark Stoops,2700000,1600,2701600,1475000,0
23,Kentucky,SEC,2013,Mark Stoops,2001250,0,2001250,1475000,0
23,Kentucky,SEC,2012,Joker Phillips,1700000,4250,1704250,1105000,0
23,Kentucky,SEC,2011,Joker Phillips,1701339,1150,1702489,1105000,0
23,Kentucky,SEC,2010,Joker Phillips,1700000,6600,1706600,1105000,0
23,Kentucky,SEC,2009,Rich Brooks,400000,1217517,1617517,1095000,0
23,Kentucky,SEC,2007,Rich Brooks,294884,761800,1056684,605000,0
23,Kentucky,SEC,2006,Rich Brooks,195000,534165,729165,85000,0
24,Virginia Tech,ACC,2018,Justin Fuente,4000000,0,4000000,435000,75000
24,Virginia Tech,ACC,2017,Justin Fuente,3250000,0,3250000,435000,125000
24,Virginia Tech,ACC,2016,Justin Fuente,3200000,0,3200000,400000,0
24,Virginia Tech,ACC,2015,Frank Beamer,2535925,240000,2775925,382500,42500
24,Virginia Tech,ACC,2014,Frank Beamer,2420913,240000,2660913,382500,0
24,Virginia Tech,ACC,2013,Frank Beamer,2491616,50000,2541616,382500,0
24,Virginia Tech,ACC,2012,Frank Beamer,2343000,85000,2428000,407500,0
24,Virginia Tech,ACC,2011,Frank Beamer,2243000,85000,2328000,407500,0
24,Virginia Tech,ACC,2010,Frank Beamer,2043000,85000,2128000,407500,0
24,Virginia Tech,ACC,2009,Frank Beamer,272328,1865672,2138000,407500,0
24,Virginia Tech,ACC,2007,Frank Beamer,272328,1735672,2008000,407500,0
24,Virginia Tech,ACC,2006,Frank Beamer,1893000,115000,2008000,407500,0
25,Louisville,ACC,2018,Bobby Petrino,3980434,0,3980434,1472917,869917
25,Louisville,ACC,2017,Bobby Petrino,3930434,0,3930434,1468750,989584
25,Louisville,ACC,2016,Bobby Petrino,3880434,30000,3910434,1464583,794667
25,Louisville,ACC,2015,Bobby Petrino,3000000,3500,3003500,1341667,782667
25,Louisville,ACC,2014,Bobby Petrino,3000000,0,3000000,1266667,0
25,Louisville,ACC,2013,Charlie Strong,3700000,38500,3738500,808333,0
25,Louisville,ACC,2012,Charlie Strong,2300000,5000,2305000,691666,0
25,Louisville,ACC,2011,Charlie Strong,2300000,5000,2305000,500000,0
25,Louisville,ACC,2010,Charlie Strong,1600000,0,1600000,633333,0
25,Louisville,ACC,2009,Steve Kragthorpe,550000,666000,1216000,525000,0
25,Louisville,ACC,2007,Steve Kragthorpe,865000,555000,1420000,566667,0
25,Louisville,ACC,2006,Bobby Petrino,810000,941000,1751000,766667,0
26,Tennessee,SEC,2018,Jeremy Pruitt,3846000,0,3846000,1200000,0
26,Tennessee,SEC,2017,Butch Jones,4110000,0,4110000,1000000,250000
26,Tennessee,SEC,2016,Butch Jones,4110000,0,4110000,1000000,350000
26,Tennessee,SEC,2015,Butch Jones,3610000,23000,3633000,1000000,300000
26,Tennessee,SEC,2014,Butch Jones,2960000,0,2960000,1000000,0
26,Tennessee,SEC,2013,Butch Jones,4860000,0,4860000,1000000,0
26,Tennessee,SEC,2012,Derek Dooley,2000000,11000,2011000,475000,0
26,Tennessee,SEC,2011,Derek Dooley,2293391,37200,2330591,475000,0
26,Tennessee,SEC,2010,Derek Dooley,2118391,3000,2121391,475000,0
26,Tennessee,SEC,2009,Lane Kiffin,350000,1650000,2000000,540000,0
26,Tennessee,SEC,2007,Phillip Fulmer,325000,1725000,2050000,250000,0
26,Tennessee,SEC,2006,Phillip Fulmer,325000,1725000,2050000,250000,0
29,Wisconsin,Big Ten,2018,Paul Chryst,3750000,0,3750000,0,290000
29,Wisconsin,Big Ten,2017,Paul Chryst,3200000,0,3200000,0,260000
29,Wisconsin,Big Ten,2016,Paul Chryst,2700000,6200,2706200,440000,100000
29,Wisconsin,Big Ten,2015,Paul Chryst,2300000,0,2300000,440000,0
29,Wisconsin,Big Ten,2014,Gary Andersen,2200000,85000,2285000,440000,0
29,Wisconsin,Big Ten,2013,Gary Andersen,2035823,85000,2120823,440000,0
29,Wisconsin,Big Ten,2012,Bret Bielema,2600000,40140,2640140,400000,0
29,Wisconsin,Big Ten,2011,Bret Bielema,2500000,98186,2598186,400000,0
29,Wisconsin,Big Ten,2010,Bret Bielema,1700000,81759,1781759,350000,0
29,Wisconsin,Big Ten,2009,Bret Bielema,400000,1081506,1481506,350000,0
29,Wisconsin,Big Ten,2007,Bret Bielema,1300000,94638,1394638,350000,0
29,Wisconsin,Big Ten,2006,Bret Bielema,750000,11600,761600,175000,0
30,Texas Tech,Big 12,2018,Kliff Kingsbury,3703975,0,3703975,1500000,25000
30,Texas Tech,Big 12,2017,Kliff Kingsbury,3503975,0,3503975,1500000,90000
30,Texas Tech,Big 12,2016,Kliff Kingsbury,3306575,0,3306575,1500000,50000
30,Texas Tech,Big 12,2015,Kliff Kingsbury,3108000,39500,3147500,1500000,70000
30,Texas Tech,Big 12,2014,Kliff Kingsbury,2605000,300,2605300,1500000,0
30,Texas Tech,Big 12,2013,Kliff Kingsbury,1855000,300,1855300,600000,0
30,Texas Tech,Big 12,2012,Tommy Tuberville,2150000,5000,2155000,1025000,0
30,Texas Tech,Big 12,2011,Tommy Tuberville,2050000,9000,2059000,1025000,0
30,Texas Tech,Big 12,2010,Tommy Tuberville,1500000,9000,1509000,1025000,0
30,Texas Tech,Big 12,2009,Mike Leach,1100000,1600000,2700000,650000,0
30,Texas Tech,Big 12,2007,Mike Leach,300000,1361500,1661500,325000,0
30,Texas Tech,Big 12,2006,Mike Leach,300000,1300000,1600000,375000,0
31,Northwestern,Big Ten,2018,Pat Fitzgerald,3619775,0,3619775,0,0
31,Northwestern,Big Ten,2017,Pat Fitzgerald,3305818,0,3305818,0,0
31,Northwestern,Big Ten,2016,Pat Fitzgerald,3350638,0,3350638,0,0
31,Northwestern,Big Ten,2015,Pat Fitzgerald,2490858,0,2490858,0,0
31,Northwestern,Big Ten,2014,Pat Fitzgerald,2480967,0,2480967,0,0
31,Northwestern,Big Ten,2013,Pat Fitzgerald,2221153,0,2221153,0,0
31,Northwestern,Big Ten,2012,Pat Fitzgerald,1280751,0,1280751,0,0
31,Northwestern,Big Ten,2011,Pat Fitzgerald,1189961,0,1189961,0,0
31,Northwestern,Big Ten,2010,Pat Fitzgerald,0,0,0,0,0
31,Northwestern,Big Ten,2009,Pat Fitzgerald,0,0,0,0,0
31,Northwestern,Big Ten,2007,Pat Fitzgerald,0,0,0,0,0
31,Northwestern,Big Ten,2006,Pat Fitzgerald,0,0,0,0,0
32,West Virginia,Big 12,2018,Dana Holgorsen,3605000,12500,3617500,1000000,90000
32,West Virginia,Big 12,2017,Dana Holgorsen,3505000,0,3505000,750000,185000
32,West Virginia,Big 12,2016,Dana Holgorsen,2980000,0,2980000,600000,60000
32,West Virginia,Big 12,2015,Dana Holgorsen,2880000,0,2880000,600000,35000
32,West Virginia,Big 12,2014,Dana Holgorsen,3080000,0,3080000,600000,0
32,West Virginia,Big 12,2013,Dana Holgorsen,2630000,0,2630000,600000,0
32,West Virginia,Big 12,2012,Dana Holgorsen,2380000,0,2380000,600000,0
32,West Virginia,Big 12,2011,Dana Holgorsen,1490000,0,1490000,600000,0
32,West Virginia,Big 12,2010,Bill Stewart,903000,30000,933000,590000,0
32,West Virginia,Big 12,2009,Bill Stewart,275000,603000,878000,565000,0
32,West Virginia,Big 12,2007,Rich Rodriguez,1203000,600000,1803000,385000,0
32,West Virginia,Big 12,2006,Rich Rodriguez,250000,850000,1100000,415000,0
33,Virginia,ACC,2018,Bronco Mendenhall,3550000,0,3550000,2165000,75000
33,Virginia,ACC,2017,Bronco Mendenhall,3400000,0,3400000,2165000,0
33,Virginia,ACC,2016,Bronco Mendenhall,3275000,0,3275000,2445000,0
33,Virginia,ACC,2015,Mike London,3196724,1676,3198400,715000,0
33,Virginia,ACC,2014,Mike London,2298413,5186,2303599,715000,0
33,Virginia,ACC,2013,Mike London,2173200,16503,2189703,715000,0
33,Virginia,ACC,2012,Mike London,2552760,3700,2556460,715000,0
33,Virginia,ACC,2011,Mike London,1780000,14679,1794679,715000,0
33,Virginia,ACC,2010,Mike London,1780000,0,1780000,715000,0
33,Virginia,ACC,2009,Al Groh,291700,1780639,2072339,940000,0
33,Virginia,ACC,2007,Al Groh,264600,1609650,1874250,940000,0
33,Virginia,ACC,2006,Al Groh,252000,1533000,1785000,940000,0
34,Minnesota,Big Ten,2018,P.J. Fleck,3550000,0,3550000,900000,0
34,Minnesota,Big Ten,2017,P.J. Fleck,3500000,0,3500000,900000,0
34,Minnesota,Big Ten,2016,Tracy Claeys,1400000,0,1400000,1250000,157942
34,Minnesota,Big Ten,2015,Jerry Kill,2500000,0,2500000,1150000,375000
34,Minnesota,Big Ten,2014,Jerry Kill,2100000,0,2100000,1150000,0
34,Minnesota,Big Ten,2013,Jerry Kill,1200000,0,1200000,875000,0
34,Minnesota,Big Ten,2012,Jerry Kill,1200000,0,1200000,875000,0
34,Minnesota,Big Ten,2011,Jerry Kill,1700000,0,1700000,875000,0
34,Minnesota,Big Ten,2010,Tim Brewster,808000,0,808000,1050000,0
34,Minnesota,Big Ten,2009,Tim Brewster,600000,400000,1000000,700000,0
34,Minnesota,Big Ten,2007,Tim Brewster,600000,400000,1000000,650000,0
34,Minnesota,Big Ten,2006,Glen Mason,760000,450000,1210000,750000,0
35,Arkansas,SEC,2018,Chad Morris,3500000,0,3500000,1000000,0
35,Arkansas,SEC,2017,Bret Bielema,4200000,45000,4245000,1000000,125000
35,Arkansas,SEC,2016,Bret Bielema,4100000,45000,4145000,1000000,100000
35,Arkansas,SEC,2015,Bret Bielema,3954166,6500,3960666,1000000,100000
35,Arkansas,SEC,2014,Bret Bielema,3200000,14000,3214000,700000,0
35,Arkansas,SEC,2013,Bret Bielema,5158863,0,5158863,700000,0
35,Arkansas,SEC,2012,John L. Smith,850000,0,850000,225000,0
35,Arkansas,SEC,2011,Bobby Petrino,3635000,3000,3638000,650000,0
35,Arkansas,SEC,2010,Bobby Petrino,2700000,13000,2713000,475000,0
35,Arkansas,SEC,2009,Bobby Petrino,1900000,958000,2858000,550000,0
35,Arkansas,SEC,2007,Houston Nutt,389644,861500,1251144,125000,0
35,Arkansas,SEC,2006,Houston Nutt,329644,720000,1049644,125000,0
37,Iowa State,Big 12,2018,Matt Campbell,3500000,0,3500000,750000,650000
37,Iowa State,Big 12,2017,Matt Campbell,2100000,0,2100000,1000000,0
37,Iowa State,Big 12,2016,Matt Campbell,2000000,0,2000000,900000,0
37,Iowa State,Big 12,2015,Paul Rhoads,2200000,5015,2205015,950000,0
37,Iowa State,Big 12,2014,Paul Rhoads,1800000,8025,1808025,1050000,0
37,Iowa State,Big 12,2013,Paul Rhoads,1700000,12282,1712282,950000,0
37,Iowa State,Big 12,2012,Paul Rhoads,1600000,1550,1601550,950000,0
37,Iowa State,Big 12,2011,Paul Rhoads,1150000,1500,1151500,1400000,0
37,Iowa State,Big 12,2010,Paul Rhoads,1050000,1145,1051145,1550000,0
37,Iowa State,Big 12,2009,Paul Rhoads,250000,700000,950000,850000,0
37,Iowa State,Big 12,2007,Gene Chizik,250000,775500,1025500,825000,0
37,Iowa State,Big 12,2006,Dan McCarney,225000,882000,1107000,375000,0
38,Washington State,Pac-12,2018,Mike Leach,3500000,0,3500000,725000,75000
38,Washington State,Pac-12,2017,Mike Leach,3075000,0,3075000,725000,75000
38,Washington State,Pac-12,2016,Mike Leach,2950000,0,2950000,725000,100000
38,Washington State,Pac-12,2015,Mike Leach,2750000,0,2750000,625000,0
38,Washington State,Pac-12,2014,Mike Leach,2750000,0,2750000,625000,0
38,Washington State,Pac-12,2013,Mike Leach,2250000,0,2250000,625000,0
38,Washington State,Pac-12,2012,Mike Leach,2250000,0,2250000,640000,0
38,Washington State,Pac-12,2011,Paul Wulff,600000,50,600050,220000,0
38,Washington State,Pac-12,2010,Paul Wulff,600000,650,600650,220000,0
38,Washington State,Pac-12,2009,Paul Wulff,250000,350100,600100,320000,0
38,Washington State,Pac-12,2007,Bill Doba,294960,361500,656460,255000,0
38,Washington State,Pac-12,2006,Bill Doba,229067,369975,599042,255000,0
39,Kansas State,Big 12,2018,Bill Snyder,3500000,0,3500000,580000,50000
39,Kansas State,Big 12,2017,Bill Snyder,3200000,5000,3205000,580000,50000
39,Kansas State,Big 12,2016,Bill Snyder,3100000,6000,3106000,580000,50000
39,Kansas State,Big 12,2015,Bill Snyder,3000000,0,3000000,580000,150000
39,Kansas State,Big 12,2014,Bill Snyder,2900000,0,2900000,580000,0
39,Kansas State,Big 12,2013,Bill Snyder,2800000,3000,2803000,580000,0
39,Kansas State,Big 12,2012,Bill Snyder,2200000,0,2200000,455000,0
39,Kansas State,Big 12,2011,Bill Snyder,1925000,0,1925000,455000,0
39,Kansas State,Big 12,2010,Bill Snyder,1875000,0,1875000,455000,0
39,Kansas State,Big 12,2009,Bill Snyder,1541667,308333,1850000,455000,0
39,Kansas State,Big 12,2007,Ron Prince,142142,612000,754142,250000,0
39,Kansas State,Big 12,2006,Ron Prince,138000,612000,750000,250000,0
41,Georgia Tech,ACC,2018,Paul Johnson,3060018,0,3060018,1330000,225000
41,Georgia Tech,ACC,2017,Paul Johnson,2970891,0,2970891,1050000,425000
41,Georgia Tech,ACC,2016,Paul Johnson,2884361,2000,2886361,1050000,235000
41,Georgia Tech,ACC,2015,Paul Johnson,2800000,2000,2802000,1050000,450000
41,Georgia Tech,ACC,2014,Paul Johnson,2588000,2500,2590500,1275000,0
41,Georgia Tech,ACC,2013,Paul Johnson,2513000,2500,2515500,1025000,0
41,Georgia Tech,ACC,2012,Paul Johnson,2440700,5000,2445700,1025000,0
41,Georgia Tech,ACC,2011,Paul Johnson,2369000,0,2369000,1125000,0
41,Georgia Tech,ACC,2010,Paul Johnson,2300000,0,2300000,1125000,0
41,Georgia Tech,ACC,2009,Paul Johnson,325000,1975000,2300000,1025000,0
41,Georgia Tech,ACC,2007,Chan Gailey,459461,579886,1039347,260000,0
41,Georgia Tech,ACC,2006,Chan Gailey,437582,571609,1009191,260000,0
42,Pittsburgh,ACC,2018,Pat Narduzzi,3017718,0,3017718,0,0
42,Pittsburgh,ACC,2017,Pat Narduzzi,1827735,0,1827735,0,0
42,Pittsburgh,ACC,2016,Pat Narduzzi,0,0,0,0,0
42,Pittsburgh,ACC,2015,Pat Narduzzi,0,0,0,0,0
42,Pittsburgh,ACC,2014,Paul Chryst,1578757,0,1578757,0,0
42,Pittsburgh,ACC,2013,Paul Chryst,0,0,0,0,0
42,Pittsburgh,ACC,2012,Paul Chryst,0,0,0,0,0
42,Pittsburgh,ACC,2011,Todd Graham,0,0,0,0,0
42,Pittsburgh,ACC,2010,Dave Wannstedt,1010873,0,1010873,0,0
42,Pittsburgh,ACC,2009,Dave Wannstedt,979288,0,979288,0,0
42,Pittsburgh,ACC,2007,Dave Wannstedt,713138,0,713138,0,0
42,Pittsburgh,ACC,2006,Dave Wannstedt,0,0,0,0,0
43,North Carolina State,ACC,2018,Dave Doeren,3000000,0,3000000,1350000,275000
43,North Carolina State,ACC,2017,Dave Doeren,2212600,0,2212600,1750000,150000
43,North Carolina State,ACC,2016,Dave Doeren,2200000,0,2200000,1750000,125000
43,North Carolina State,ACC,2015,Dave Doeren,2200000,0,2200000,1750000,100000
43,North Carolina State,ACC,2014,Dave Doeren,1800000,0,1800000,1000000,0
43,North Carolina State,ACC,2013,Dave Doeren,2550000,5000,2555000,1000000,0
43,North Carolina State,ACC,2012,Tom O'Brien,936225,1000000,1936225,1110000,0
43,North Carolina State,ACC,2011,Tom O'Brien,932950,945000,1877950,750000,0
43,North Carolina State,ACC,2010,Tom O'Brien,632950,887500,1520450,750000,0
43,North Carolina State,ACC,2009,Tom O'Brien,625000,575000,1200000,700000,0
43,North Carolina State,ACC,2007,Tom O'Brien,600000,500000,1100000,850000,0
43,North Carolina State,ACC,2006,Chuck Amato,185000,810000,995000,0,0
44,Mississippi,SEC,2018,Matt Luke,3000000,0,3000000,1550000,0
44,Mississippi,SEC,2017,Matt Luke,1160000,0,1160000,0,0
44,Mississippi,SEC,2016,Hugh Freeze,4700000,3500,4703500,1225000,300000
44,Mississippi,SEC,2015,Hugh Freeze,4300000,10000,4310000,975000,125000
44,Mississippi,SEC,2014,Hugh Freeze,3000000,18000,3018000,825000,0
44,Mississippi,SEC,2013,Hugh Freeze,2000000,5500,2005500,1575000,0
44,Mississippi,SEC,2012,Hugh Freeze,1500000,5500,1505500,1475000,0
44,Mississippi,SEC,2011,Houston Nutt,2756250,15500,2771750,715000,0
44,Mississippi,SEC,2010,Houston Nutt,2500000,9000,2509000,0,0
44,Mississippi,SEC,2009,Houston Nutt,200000,2309000,2509000,715000,0
44,Mississippi,SEC,2007,Ed Orgeron,200000,700000,900000,0,0
44,Mississippi,SEC,2006,Ed Orgeron,900000,5000,905000,0,0
45,Colorado,Pac-12,2018,Mike MacIntyre,2878500,0,2878500,2150000,297000
45,Colorado,Pac-12,2017,Mike MacIntyre,2803500,0,2803500,2150000,772500
45,Colorado,Pac-12,2016,Mike MacIntyre,2011050,400,2011450,1500000,300000
45,Colorado,Pac-12,2015,Mike MacIntyre,2009778,575,2010353,1500000,292000
45,Colorado,Pac-12,2014,Mike MacIntyre,2008500,1650,2010150,1500000,0
45,Colorado,Pac-12,2013,Mike MacIntyre,2403500,0,2403500,1500000,0
45,Colorado,Pac-12,2012,Jon Embree,725000,0,725000,1400000,0
45,Colorado,Pac-12,2011,Jon Embree,725000,0,725000,1400000,0
45,Colorado,Pac-12,2010,Dan Hawkins,1383903,8000,1391903,985444,0
45,Colorado,Pac-12,2009,Dan Hawkins,174720,825850,1000570,900000,0
45,Colorado,Pac-12,2007,Dan Hawkins,166400,769500,935900,550000,0
45,Colorado,Pac-12,2006,Dan Hawkins,355000,743500,1098500,550000,0
46,Vanderbilt,SEC,2018,Derek Mason,2812523,0,2812523,0,0
46,Vanderbilt,SEC,2017,Derek Mason,2721834,0,2721834,0,0
46,Vanderbilt,SEC,2016,Derek Mason,2556877,0,2556877,0,0
46,Vanderbilt,SEC,2015,Derek Mason,0,0,0,0,0
46,Vanderbilt,SEC,2014,Derek Mason,0,0,0,0,0
46,Vanderbilt,SEC,2013,James Franklin,1842771,0,1842771,0,0
46,Vanderbilt,SEC,2012,James Franklin,0,0,0,0,0
46,Vanderbilt,SEC,2011,James Franklin,0,0,0,0,0
46,Vanderbilt,SEC,2010,Robbie Caldwell,0,0,0,0,0
46,Vanderbilt,SEC,2009,Bobby Johnson,0,0,0,0,0
46,Vanderbilt,SEC,2007,Bobby Johnson,0,0,0,0,0
46,Vanderbilt,SEC,2006,Bobby Johnson,0,0,0,0,0
47,Southern California,Pac-12,2018,Clay Helton,2625965,0,2625965,0,0
47,Southern California,Pac-12,2017,Clay Helton,0,0,0,0,0
47,Southern California,Pac-12,2016,Clay Helton,0,0,0,0,0
47,Southern California,Pac-12,2015,Steve Sarkisian,0,0,0,0,0
47,Southern California,Pac-12,2014,Steve Sarkisian,0,0,0,0,0
47,Southern California,Pac-12,2013,Lane Kiffin,2594091,0,2594091,0,0
47,Southern California,Pac-12,2012,Lane Kiffin,2406505,0,2406505,0,0
47,Southern California,Pac-12,2011,Lane Kiffin,0,0,0,0,0
47,Southern California,Pac-12,2010,Lane Kiffin,0,0,0,0,0
47,Southern California,Pac-12,2009,Pete Carroll,4386652,0,4386652,0,0
47,Southern California,Pac-12,2007,Pete Carroll,2794656,0,2794656,0,0
47,Southern California,Pac-12,2006,Pete Carroll,2782320,0,2782320,0,0
48,Memphis,AAC,2018,Mike Norvell,2600000,0,2600000,775000,185000
48,Memphis,AAC,2017,Mike Norvell,1860000,0,1860000,570000,125000
48,Memphis,AAC,2016,Mike Norvell,1800000,0,1800000,570000,0
48,Memphis,AAC,2015,Justin Fuente,1400000,0,1400000,725000,235000
48,Memphis,AAC,2014,Justin Fuente,1006779,0,1006779,725000,0
48,Memphis,AAC,2013,Justin Fuente,956779,0,956779,625000,0
48,Memphis,AAC,2012,Justin Fuente,903285,0,903285,625000,0
48,Memphis,AAC,2011,Larry Porter,754890,0,754890,190000,0
48,Memphis,AAC,2010,Larry Porter,750000,0,750000,190000,0
48,Memphis,AAC,2009,Tommy West,155000,770000,925000,400000,0
48,Memphis,AAC,2007,Tommy West,159650,771000,930650,430000,0
48,Memphis,AAC,2006,Tommy West,155000,770000,925000,430000,0
49,Mississippi State,SEC,2018,Joe Moorhead,2600000,0,2600000,1350000,0
49,Mississippi State,SEC,2017,Dan Mullen,4500000,0,4500000,1150000,150000
49,Mississippi State,SEC,2016,Dan Mullen,4200000,0,4200000,900000,200000
49,Mississippi State,SEC,2015,Dan Mullen,4000000,0,4000000,900000,390000
49,Mississippi State,SEC,2014,Dan Mullen,3000000,0,3000000,710000,0
49,Mississippi State,SEC,2013,Dan Mullen,2700000,0,2700000,650000,0
49,Mississippi State,SEC,2012,Dan Mullen,2600000,0,2600000,650000,0
49,Mississippi State,SEC,2011,Dan Mullen,2500000,0,2500000,650000,0
49,Mississippi State,SEC,2010,Dan Mullen,1200000,8295,1208295,0,0
49,Mississippi State,SEC,2009,Dan Mullen,250000,950000,1200000,100000,0
49,Mississippi State,SEC,2007,Sylvester Croom,205000,770000,975000,0,0
49,Mississippi State,SEC,2006,Sylvester Croom,190000,750000,940000,15833,0
50,North Carolina,ACC,2018,Larry Fedora,2575000,0,2575000,900000,50000
50,North Carolina,ACC,2017,Larry Fedora,2290000,0,2290000,900000,50000
50,North Carolina,ACC,2016,Larry Fedora,1986265,0,1986265,348444,58500
50,North Carolina,ACC,2015,Larry Fedora,1931000,0,1931000,346250,29250
50,North Carolina,ACC,2014,Larry Fedora,1830000,0,1830000,345835,0
50,North Carolina,ACC,2013,Larry Fedora,1730000,0,1730000,345835,0
50,North Carolina,ACC,2012,Larry Fedora,2448605,0,2448605,29167,0
50,North Carolina,ACC,2011,Everett Withers,500000,0,500000,100000,0
50,North Carolina,ACC,2010,Butch Davis,1752000,0,1752000,105000,0
50,North Carolina,ACC,2009,Butch Davis,1702000,0,1702000,105000,0
50,North Carolina,ACC,2007,Butch Davis,1411000,499000,1910000,95333,0
50,North Carolina,ACC,2006,John Bunting,311200,0,311200,43334,0
52,Boston College,ACC,2018,Steve Addazio,2514859,0,2514859,0,0
52,Boston College,ACC,2017,Steve Addazio,2448949,0,2448949,0,0
52,Boston College,ACC,2016,Steve Addazio,2333628,0,2333628,0,0
52,Boston College,ACC,2015,Steve Addazio,2585655,0,2585655,0,0
52,Boston College,ACC,2014,Steve Addazio,0,0,0,0,0
52,Boston College,ACC,2013,Steve Addazio,0,0,0,0,0
52,Boston College,ACC,2012,Frank Spaziani,1094976,0,1094976,0,0
52,Boston College,ACC,2011,Frank Spaziani,1079410,0,1079410,0,0
52,Boston College,ACC,2010,Frank Spaziani,0,0,0,0,0
52,Boston College,ACC,2009,Frank Spaziani,0,0,0,0,0
52,Boston College,ACC,2007,Jeff Jagodzinski,0,0,0,0,0
52,Boston College,ACC,2006,Tom O'Brien,733626,0,733626,0,0
53,Maryland,Big Ten,2018,DJ Durkin,2512000,0,2512000,625000,0
53,Maryland,Big Ten,2017,DJ Durkin,2462000,0,2462000,625000,25000
53,Maryland,Big Ten,2016,DJ Durkin,2412000,0,2412000,625000,0
53,Maryland,Big Ten,2015,Randy Edsall,2110648,200,2110848,950000,200000
53,Maryland,Big Ten,2014,Randy Edsall,2033680,200,2033880,950000,0
53,Maryland,Big Ten,2013,Randy Edsall,2021440,4000,2025440,950000,0
53,Maryland,Big Ten,2012,Randy Edsall,1600000,4000,1604000,950000,0
53,Maryland,Big Ten,2011,Randy Edsall,2013440,0,2013440,875000,0
53,Maryland,Big Ten,2010,Ralph Friedgen,2036306,7000,2043306,737232,0
53,Maryland,Big Ten,2009,Ralph Friedgen,267468,1609627,1877095,701954,0
53,Maryland,Big Ten,2007,Ralph Friedgen,244136,1506070,1750206,636692,0
53,Maryland,Big Ten,2006,Ralph Friedgen,252511,1439353,1691864,550000,0
54,Oregon,Pac-12,2018,Mario Cristobal,2500000,0,2500000,1825000,0
54,Oregon,Pac-12,2017,Willie Taggart,2900000,0,2900000,1825000,0
54,Oregon,Pac-12,2016,Mark Helfrich,3300000,12700,3312700,1635000,150000
54,Oregon,Pac-12,2015,Mark Helfrich,3150000,0,3150000,1635000,535000
54,Oregon,Pac-12,2014,Mark Helfrich,2000000,0,2000000,1135000,0
54,Oregon,Pac-12,2013,Mark Helfrich,1800000,0,1800000,1035000,0
54,Oregon,Pac-12,2012,Chip Kelly,3500000,0,3500000,900000,0
54,Oregon,Pac-12,2011,Chip Kelly,2800000,0,2800000,1035000,0
54,Oregon,Pac-12,2010,Chip Kelly,2400000,0,2400000,885000,0
54,Oregon,Pac-12,2009,Chip Kelly,850000,650000,1500000,1275000,0
54,Oregon,Pac-12,2007,Mike Bellotti,730232,325000,1055232,402500,0
54,Oregon,Pac-12,2006,Mike Bellotti,1101000,155000,1256000,368000,0
55,Syracuse,ACC,2018,Dino Babers,2401206,0,2401206,0,0
55,Syracuse,ACC,2017,Dino Babers,0,0,0,0,0
55,Syracuse,ACC,2016,Dino Babers,0,0,0,0,0
55,Syracuse,ACC,2015,Scott Shafer,1302721,0,1302721,0,0
55,Syracuse,ACC,2014,Scott Shafer,0,0,0,0,0
55,Syracuse,ACC,2013,Scott Shafer,0,0,0,0,0
55,Syracuse,ACC,2012,Doug Marrone,1259276,0,1259276,0,0
55,Syracuse,ACC,2011,Doug Marrone,1048625,0,1048625,0,0
55,Syracuse,ACC,2010,Doug Marrone,0,0,0,0,0
55,Syracuse,ACC,2009,Doug Marrone,0,0,0,0,0
55,Syracuse,ACC,2007,Greg Robinson,1054172,0,1054172,0,0
55,Syracuse,ACC,2006,Greg Robinson,638441,0,638441,0,0
56,Missouri,SEC,2018,Barry Odom,2350000,0,2350000,1025000,375000
56,Missouri,SEC,2017,Barry Odom,2350000,0,2350000,1025000,162500
56,Missouri,SEC,2016,Barry Odom,2350000,0,2350000,1025000,0
56,Missouri,SEC,2015,Gary Pinkel,3768889,0,3768889,725000,900000
56,Missouri,SEC,2014,Gary Pinkel,3400000,0,3400000,1825000,0
56,Missouri,SEC,2013,Gary Pinkel,2800000,200,2800200,850000,0
56,Missouri,SEC,2012,Gary Pinkel,2700000,0,2700000,850000,0
56,Missouri,SEC,2011,Gary Pinkel,2700000,0,2700000,850000,0
56,Missouri,SEC,2010,Gary Pinkel,2550000,0,2550000,850000,0
56,Missouri,SEC,2009,Gary Pinkel,575000,1950000,2525000,850000,0
56,Missouri,SEC,2007,Gary Pinkel,275000,1045000,1320000,473750,0
56,Missouri,SEC,2006,Gary Pinkel,395000,700000,1095000,462499,0
57,Rutgers,Big Ten,2018,Chris Ash,2200000,0,2200000,960000,50000
57,Rutgers,Big Ten,2017,Chris Ash,2100000,0,2100000,960000,50000
57,Rutgers,Big Ten,2016,Chris Ash,2000000,0,2000000,960000,0
57,Rutgers,Big Ten,2015,Kyle Flood,1250000,10000,1260000,425000,85000
57,Rutgers,Big Ten,2014,Kyle Flood,975000,12000,987000,350000,0
57,Rutgers,Big Ten,2013,Kyle Flood,850000,10000,860000,350000,0
57,Rutgers,Big Ten,2012,Kyle Flood,750000,10000,760000,350000,0
57,Rutgers,Big Ten,2011,Greg Schiano,2195000,101969,2296969,530000,0
57,Rutgers,Big Ten,2010,Greg Schiano,1895000,105932,2000932,630000,0
57,Rutgers,Big Ten,2009,Greg Schiano,1715000,355932,2070932,530000,0
57,Rutgers,Big Ten,2007,Greg Schiano,1600000,133500,1733500,530000,0
57,Rutgers,Big Ten,2006,Greg Schiano,875000,36000,911000,480000,0
59,Notre Dame,ACC,2018,Brian Kelly,2129638,0,2129638,0,0
59,Notre Dame,ACC,2017,Brian Kelly,1645867,0,1645867,0,0
59,Notre Dame,ACC,2016,Brian Kelly,1624730,0,1624730,0,0
59,Notre Dame,ACC,2015,Brian Kelly,1187272,0,1187272,0,0
59,Notre Dame,ACC,2014,Brian Kelly,1457284,0,1457284,0,0
59,Notre Dame,ACC,2013,Brian Kelly,1088179,0,1088179,0,0
59,Notre Dame,ACC,2012,Brian Kelly,2424301,0,2424301,0,0
59,Notre Dame,ACC,2011,Brian Kelly,0,0,0,0,0
59,Notre Dame,ACC,2010,Brian Kelly,0,0,0,0,0
59,Notre Dame,ACC,2009,Charlie Weis,640851,0,640851,0,0
59,Notre Dame,ACC,2007,Charlie Weis,673779,0,673779,0,0
59,Notre Dame,ACC,2006,Charlie Weis,0,0,0,0,0
60,Cincinnati,AAC,2018,Luke Fickell,2000000,0,2000000,625000,0
60,Cincinnati,AAC,2017,Luke Fickell,1900000,0,1900000,625000,0
60,Cincinnati,AAC,2016,Tommy Tuberville,2200000,0,2200000,565000,70000
60,Cincinnati,AAC,2015,Tommy Tuberville,2200000,0,2200000,540000,140000
60,Cincinnati,AAC,2014,Tommy Tuberville,2200000,0,2200000,565000,0
60,Cincinnati,AAC,2013,Tommy Tuberville,3143000,0,3143000,465000,0
60,Cincinnati,AAC,2012,Butch Jones,1769648,0,1769648,330000,0
60,Cincinnati,AAC,2011,Butch Jones,1393333,500,1393833,330000,0
60,Cincinnati,AAC,2010,Butch Jones,1100000,1500,1101500,320000,0
60,Cincinnati,AAC,2009,Brian Kelly,315000,1047500,1362500,400000,0
60,Cincinnati,AAC,2007,Brian Kelly,385000,450000,835000,380000,0
60,Cincinnati,AAC,2006,Mark Dantonio,270000,225000,495000,701667,0
61,Arizona,Pac-12,2018,Kevin Sumlin,1600000,400000,2000000,2025000,0
61,Arizona,Pac-12,2017,Rich Rodriguez,5631563,400000,6031563,2025000,25000
61,Arizona,Pac-12,2016,Rich Rodriguez,2500000,360000,2860000,2025000,50000
61,Arizona,Pac-12,2015,Rich Rodriguez,2878844,360000,3238844,2025000,650000
61,Arizona,Pac-12,2014,Rich Rodriguez,2898500,400000,3298500,2125000,0
61,Arizona,Pac-12,2013,Rich Rodriguez,1850000,300000,2150000,610000,0
61,Arizona,Pac-12,2012,Rich Rodriguez,1500000,0,1500000,525000,0
61,Arizona,Pac-12,2011,Mike Stoops,1200000,265000,1465000,700000,0
61,Arizona,Pac-12,2010,Mike Stoops,1100000,285838,1385838,650000,0
61,Arizona,Pac-12,2009,Mike Stoops,500000,765000,1265000,650000,0
61,Arizona,Pac-12,2007,Mike Stoops,515288,500000,1015288,580000,0
61,Arizona,Pac-12,2006,Mike Stoops,415000,450000,865000,395000,0
62,Arizona State,Pac-12,2018,Herm Edwards,2000000,0,2000000,3010000,0
62,Arizona State,Pac-12,2017,Todd Graham,3200000,8779,3208779,3906000,445000
62,Arizona State,Pac-12,2016,Todd Graham,3100000,3438,3103438,3823000,375000
62,Arizona State,Pac-12,2015,Todd Graham,3000000,2960,3002960,3740000,627000
62,Arizona State,Pac-12,2014,Todd Graham,2700000,2960,2702960,3491000,0
62,Arizona State,Pac-12,2013,Todd Graham,2300000,3020,2303020,3159000,0
62,Arizona State,Pac-12,2012,Todd Graham,3000000,0,3000000,2050000,0
62,Arizona State,Pac-12,2011,Dennis Erickson,1500000,3000,1503000,1800000,0
62,Arizona State,Pac-12,2010,Dennis Erickson,1500000,3000,1503000,1800000,0
62,Arizona State,Pac-12,2009,Dennis Erickson,450000,1052643,1502643,1800000,0
62,Arizona State,Pac-12,2007,Dennis Erickson,450000,50000,500000,1195000,0
62,Arizona State,Pac-12,2006,Dirk Koetter,950000,41000,991000,1234000,0
63,Oregon State,Pac-12,2018,Jonathan Smith,1900008,0,1900008,1275000,0
63,Oregon State,Pac-12,2017,Gary Andersen,2650000,0,2650000,525000,50000
63,Oregon State,Pac-12,2016,Gary Andersen,2550000,0,2550000,525000,0
63,Oregon State,Pac-12,2015,Gary Andersen,2450000,0,2450000,525000,0
63,Oregon State,Pac-12,2014,Mike Riley,1510008,0,1510008,369000,0
63,Oregon State,Pac-12,2013,Mike Riley,1417843,0,1417843,360000,0
63,Oregon State,Pac-12,2012,Mike Riley,1317847,0,1317847,360000,0
63,Oregon State,Pac-12,2011,Mike Riley,1313471,0,1313471,360000,0
63,Oregon State,Pac-12,2010,Mike Riley,1110000,0,1110000,360000,0
63,Oregon State,Pac-12,2009,Mike Riley,525000,425000,950000,395000,0
63,Oregon State,Pac-12,2007,Mike Riley,460000,425000,885000,360000,0
63,Oregon State,Pac-12,2006,Mike Riley,410000,425000,835000,295000,0
64,Wake Forest,ACC,2018,Dave Clawson,1831580,0,1831580,0,0
64,Wake Forest,ACC,2017,Dave Clawson,1827370,0,1827370,0,0
64,Wake Forest,ACC,2016,Dave Clawson,2113166,0,2113166,0,0
64,Wake Forest,ACC,2015,Dave Clawson,0,0,0,0,0
64,Wake Forest,ACC,2014,Dave Clawson,0,0,0,0,0
64,Wake Forest,ACC,2013,Jim Grobe,2251635,0,2251635,0,0
64,Wake Forest,ACC,2012,Jim Grobe,2254798,0,2254798,0,0
64,Wake Forest,ACC,2011,Jim Grobe,2275545,0,2275545,0,0
64,Wake Forest,ACC,2010,Jim Grobe,2939475,0,2939475,0,0
64,Wake Forest,ACC,2009,Jim Grobe,333000,1839127,2172127,343000,0
64,Wake Forest,ACC,2007,Jim Grobe,1021379,0,1021379,0,0
64,Wake Forest,ACC,2006,Jim Grobe,987843,0,987843,0,0
65,Indiana,Big Ten,2018,Tom Allen,1830000,0,1830000,1441668,0
65,Indiana,Big Ten,2017,Tom Allen,1830000,0,1830000,1441668,0
65,Indiana,Big Ten,2016,Kevin Wilson,2320000,0,2320000,1130000,175000
65,Indiana,Big Ten,2015,Kevin Wilson,1312277,0,1312277,1130000,25000
65,Indiana,Big Ten,2014,Kevin Wilson,1301644,0,1301644,1130000,0
65,Indiana,Big Ten,2013,Kevin Wilson,1291220,0,1291220,780000,0
65,Indiana,Big Ten,2012,Kevin Wilson,1260000,0,1260000,830000,0
65,Indiana,Big Ten,2011,Kevin Wilson,1260000,0,1260000,830000,0
65,Indiana,Big Ten,2010,Bill Lynch,650000,0,650000,450000,0
65,Indiana,Big Ten,2009,Bill Lynch,308750,350000,658750,450000,0
65,Indiana,Big Ten,2007,Bill Lynch,193297,100000,293297,200000,0
65,Indiana,Big Ten,2006,Terry Hoeppner,300000,300000,600000,200000,0
66,Colorado State,Mt. West,2018,Mike Bobo,1800000,0,1800000,905000,50000
66,Colorado State,Mt. West,2017,Mike Bobo,1550000,0,1550000,785000,50000
66,Colorado State,Mt. West,2016,Mike Bobo,1450000,0,1450000,685000,50000
66,Colorado State,Mt. West,2015,Mike Bobo,1350000,0,1350000,685000,0
66,Colorado State,Mt. West,2014,Jim McElwain,1500000,0,1500000,150000,0
66,Colorado State,Mt. West,2013,Jim McElwain,1350000,0,1350000,150000,0
66,Colorado State,Mt. West,2012,Jim McElwain,1350000,0,1350000,150000,0
66,Colorado State,Mt. West,2011,Steve Fairchild,700000,0,700000,455000,0
66,Colorado State,Mt. West,2010,Steve Fairchild,700000,0,700000,435000,0
66,Colorado State,Mt. West,2009,Steve Fairchild,350000,350000,700000,455000,0
66,Colorado State,Mt. West,2007,Sonny Lubick,414500,135000,549500,171625,0
66,Colorado State,Mt. West,2006,Sonny Lubick,394900,135000,529900,169991,0
67,Houston,AAC,2018,Major Applewhite,1750000,0,1750000,782500,20000
67,Houston,AAC,2017,Major Applewhite,1750000,0,1750000,782500,0
67,Houston,AAC,2016,Tom Herman,3000000,3500,3003500,447500,137500
67,Houston,AAC,2015,Tom Herman,1450000,0,1450000,447500,0
67,Houston,AAC,2014,Tony Levine,1025000,300,1025300,422500,0
67,Houston,AAC,2013,Tony Levine,900000,2100,902100,340000,0
67,Houston,AAC,2012,Tony Levine,900000,0,900000,370000,0
67,Houston,AAC,2011,Kevin Sumlin,1200000,0,1200000,500000,0
67,Houston,AAC,2010,Kevin Sumlin,1000000,0,1000000,500000,0
67,Houston,AAC,2009,Kevin Sumlin,350000,400000,750000,325000,0
67,Houston,AAC,2007,Art Briles,380000,550000,930000,275000,0
67,Houston,AAC,2006,Art Briles,250000,300000,550000,190000,0
68,Kansas,Big 12,2018,David Beaty,1701109,0,1701109,2000000,0
68,Kansas,Big 12,2017,David Beaty,1601109,0,1601109,1750000,25000
68,Kansas,Big 12,2016,David Beaty,801109,0,801109,925000,0
68,Kansas,Big 12,2015,David Beaty,801169,0,801169,925000,0
68,Kansas,Big 12,2014,Charlie Weis,2500000,0,2500000,765000,0
68,Kansas,Big 12,2013,Charlie Weis,2500000,3727,2503727,615000,0
68,Kansas,Big 12,2012,Charlie Weis,2500000,0,2500000,615000,0
68,Kansas,Big 12,2011,Turner Gill,2100000,1200,2101200,419158,0
68,Kansas,Big 12,2010,Turner Gill,2100000,1200,2101200,419158,0
68,Kansas,Big 12,2009,Mark Mangino,529900,1773600,2303500,675000,0
68,Kansas,Big 12,2007,Mark Mangino,229900,1294040,1523940,425000,0
68,Kansas,Big 12,2006,Mark Mangino,220000,1288381,1508381,425000,0
69,Central Florida,AAC,2018,Josh Heupel,1700000,0,1700000,250000,0
69,Central Florida,AAC,2017,Scott Frost,2000000,0,2000000,250000,45000
69,Central Florida,AAC,2016,Scott Frost,1700000,0,1700000,250000,0
69,Central Florida,AAC,2015,George O'Leary,1890000,0,1890000,750000,385000
69,Central Florida,AAC,2014,George O'Leary,1800000,0,1800000,750000,0
69,Central Florida,AAC,2013,George O'Leary,1534728,0,1534728,600000,0
69,Central Florida,AAC,2012,George O'Leary,1461646,0,1461646,600000,0
69,Central Florida,AAC,2011,George O'Leary,1392043,0,1392043,600000,0
69,Central Florida,AAC,2010,George O'Leary,1325754,0,1325754,600000,0
69,Central Florida,AAC,2009,George O'Leary,310466,1002159,1312625,600000,0
69,Central Florida,AAC,2007,George O'Leary,261250,823750,1085000,500000,0
69,Central Florida,AAC,2006,George O'Leary,250000,785000,1035000,555000,0
70,Boise State,Mt. West,2018,Bryan Harsin,1650010,0,1650010,475000,145000
70,Boise State,Mt. West,2017,Bryan Harsin,1550004,0,1550004,475000,55000
70,Boise State,Mt. West,2016,Bryan Harsin,1300004,0,1300004,400000,85000
70,Boise State,Mt. West,2015,Bryan Harsin,1100004,0,1100004,400000,182875
70,Boise State,Mt. West,2014,Bryan Harsin,1000004,0,1000004,400000,0
70,Boise State,Mt. West,2013,Chris Petersen,2148000,3500,2151500,290000,0
70,Boise State,Mt. West,2012,Chris Petersen,1956333,3500,1959833,290000,0
70,Boise State,Mt. West,2011,Chris Petersen,1525000,0,1525000,170000,0
70,Boise State,Mt. West,2010,Chris Petersen,1489053,5000,1494053,145000,0
70,Boise State,Mt. West,2009,Chris Petersen,995250,127900,1123150,227313,0
70,Boise State,Mt. West,2007,Chris Petersen,857500,23500,881000,215833,0
70,Boise State,Mt. West,2006,Chris Petersen,502500,9300,511800,186667,0
72,Fresno State,Mt. West,2018,Jeff Tedford,1550000,0,1550000,2765000,1240000
72,Fresno State,Mt. West,2017,Jeff Tedford,1550000,0,1550000,2765000,0
72,Fresno State,Mt. West,2016,Tim DeRuyter,1518480,30000,1548480,1685000,245000
72,Fresno State,Mt. West,2015,Tim DeRuyter,1457745,35000,1492745,1685000,420000
72,Fresno State,Mt. West,2014,Tim DeRuyter,1400000,35000,1435000,1685000,0
72,Fresno State,Mt. West,2013,Tim DeRuyter,650000,5000,655000,1685000,0
72,Fresno State,Mt. West,2012,Tim DeRuyter,650000,0,650000,1610000,0
72,Fresno State,Mt. West,2011,Pat Hill,650000,29000,679000,870000,0
72,Fresno State,Mt. West,2010,Pat Hill,952499,46810,999309,697167,0
72,Fresno State,Mt. West,2009,Pat Hill,625000,338506,963506,651583,0
72,Fresno State,Mt. West,2007,Pat Hill,684236,545760,1229996,0,0
72,Fresno State,Mt. West,2006,Pat Hill,1231421,22561,1253982,0,0
74,California,Pac-12,2018,Justin Wilcox,1500000,0,1500000,900000,75000
74,California,Pac-12,2017,Justin Wilcox,1600000,0,1600000,900000,0
74,California,Pac-12,2016,Sonny Dykes,2900000,8000,2908000,800000,50000
74,California,Pac-12,2015,Sonny Dykes,2000000,8000,2008000,304000,0
74,California,Pac-12,2014,Sonny Dykes,1800000,8000,1808000,304000,0
74,California,Pac-12,2013,Sonny Dykes,2394000,0,2394000,304000,0
74,California,Pac-12,2012,Jeff Tedford,2600000,0,2600000,255000,0
74,California,Pac-12,2011,Jeff Tedford,2300000,0,2300000,255000,0
74,California,Pac-12,2010,Jeff Tedford,2300000,5000,2305000,265000,0
74,California,Pac-12,2009,Jeff Tedford,1225000,1582500,2807500,265000,0
74,California,Pac-12,2007,Jeff Tedford,225000,1580800,1805800,400000,0
74,California,Pac-12,2006,Jeff Tedford,167500,1337800,1505300,350000,0
75,North Texas,C-USA,2018,Seth Littrell,1425000,0,1425000,580000,130000
75,North Texas,C-USA,2017,Seth Littrell,991416,0,991416,580000,35000
75,North Texas,C-USA,2016,Seth Littrell,815000,0,815000,535000,0
75,North Texas,C-USA,2015,Dan McCarney,720000,1600,721600,945000,0
75,North Texas,C-USA,2014,Dan McCarney,710000,1600,711600,945000,0
75,North Texas,C-USA,2013,Dan McCarney,545000,300,545300,85000,0
75,North Texas,C-USA,2012,Dan McCarney,545000,300,545300,75000,0
75,North Texas,C-USA,2011,Dan McCarney,545000,0,545000,75000,0
75,North Texas,C-USA,2010,Todd Dodge,289161,0,289161,101000,0
75,North Texas,C-USA,2009,Todd Dodge,230000,49963,279963,101000,0
75,North Texas,C-USA,2007,Todd Dodge,230000,31000,261000,82000,0
75,North Texas,C-USA,2006,Darrell Dickey,232425,34200,266625,92000,0
76,Wyoming,Mt. West,2018,Craig Bohl,1412000,0,1412000,450000,236000
76,Wyoming,Mt. West,2017,Craig Bohl,1412000,0,1412000,450000,213750
76,Wyoming,Mt. West,2016,Craig Bohl,909000,0,909000,330000,105000
76,Wyoming,Mt. West,2015,Craig Bohl,882000,0,882000,330000,120000
76,Wyoming,Mt. West,2014,Craig Bohl,832000,0,832000,330000,0
76,Wyoming,Mt. West,2013,Dave Christensen,1200000,0,1200000,25000,0
76,Wyoming,Mt. West,2012,Dave Christensen,1200000,0,1200000,25000,0
76,Wyoming,Mt. West,2011,Dave Christensen,843376,0,843376,260000,0
76,Wyoming,Mt. West,2010,Dave Christensen,861000,0,861000,260000,0
76,Wyoming,Mt. West,2009,Dave Christensen,391730,210000,601730,470970,0
76,Wyoming,Mt. West,2007,Joe Glenn,472349,78960,551309,37527,0
76,Wyoming,Mt. West,2006,Joe Glenn,430100,75000,505100,37527,0
78,East Carolina,AAC,2018,Scottie Montgomery,1102500,0,1102500,850000,0
78,East Carolina,AAC,2017,Scottie Montgomery,1050000,0,1050000,850000,75000
78,East Carolina,AAC,2016,Scottie Montgomery,1000000,0,1000000,850000,0
78,East Carolina,AAC,2015,Ruffin McNeill,1414610,2500,1417110,550000,75000
78,East Carolina,AAC,2014,Ruffin McNeill,1250000,2500,1252500,550000,0
78,East Carolina,AAC,2013,Ruffin McNeill,1150000,0,1150000,380000,0
78,East Carolina,AAC,2012,Ruffin McNeill,950000,0,950000,350000,0
78,East Carolina,AAC,2011,Ruffin McNeill,881860,3000,884860,350000,0
78,East Carolina,AAC,2010,Ruffin McNeill,792241,2000,794241,350000,0
78,East Carolina,AAC,2009,Skip Holtz,947863,435000,1382863,125000,0
78,East Carolina,AAC,2007,Skip Holtz,210060,350000,560060,125000,0
78,East Carolina,AAC,2006,Skip Holtz,150000,275000,425000,75000,0
79,Texas-San Antonio,C-USA,2018,Frank Wilson,1100000,0,1100000,185000,17500
79,Texas-San Antonio,C-USA,2017,Frank Wilson,1137500,0,1137500,185000,17500
79,Texas-San Antonio,C-USA,2016,Frank Wilson,835000,0,835000,185000,0
79,Texas-San Antonio,C-USA,2015,Larry Coker,425000,2150,427150,255000,0
79,Texas-San Antonio,C-USA,2014,Larry Coker,400000,2150,402150,230000,0
79,Texas-San Antonio,C-USA,2013,Larry Coker,350000,1150,351150,30000,0
79,Texas-San Antonio,C-USA,2012,Larry Coker,350000,1150,351150,30000,0
5,Auburn,SEC,2018,Gus Malzahn,6700000,5656,6705656,1400000,375000
5,Auburn,SEC,2017,Gus Malzahn,4725000,1960,4726960,1400000,275000
5,Auburn,SEC,2016,Gus Malzahn,4725000,4500,4729500,1400000,125000
5,Auburn,SEC,2015,Gus Malzahn,4100000,4500,4104500,1400000,125000
5,Auburn,SEC,2014,Gus Malzahn,3850000,4500,3854500,1400000,0
5,Auburn,SEC,2013,Gus Malzahn,2440000,0,2440000,1250000,0
5,Auburn,SEC,2012,Gene Chizik,3500000,77500,3577500,1200000,0
5,Auburn,SEC,2011,Gene Chizik,3500000,0,3500000,1200000,0
5,Auburn,SEC,2010,Gene Chizik,2100000,3500,2103500,1500000,0
5,Auburn,SEC,2009,Gene Chizik,500000,1550000,2050000,1300000,0
5,Auburn,SEC,2007,Tommy Tuberville,435000,2190000,2625000,717500,0
5,Auburn,SEC,2006,Tommy Tuberville,235000,1996000,2231000,716154,0
8,Florida,SEC,2018,Dan Mullen,6070000,0,6070000,925000,0
8,Florida,SEC,2017,Jim McElwain,4457400,0,4457400,925000,300000
8,Florida,SEC,2016,Jim McElwain,4268325,0,4268325,450000,100000
8,Florida,SEC,2015,Jim McElwain,3983359,0,3983359,450000,0
8,Florida,SEC,2014,Will Muschamp,2724500,6500,2731000,454000,0
8,Florida,SEC,2013,Will Muschamp,2724500,10000,2734500,454000,0
8,Florida,SEC,2012,Will Muschamp,2474500,0,2474500,450000,0
8,Florida,SEC,2011,Will Muschamp,3221000,0,3221000,450000,0
8,Florida,SEC,2010,Urban Meyer,4010000,0,4010000,575000,0
8,Florida,SEC,2009,Urban Meyer,250000,3750000,4000000,0,0
8,Florida,SEC,2007,Urban Meyer,238702,3144798,3383500,0,0
8,Florida,SEC,2006,Urban Meyer,491750,1032800,1524550,454000,0
9,Texas,Big 12,2018,Tom Herman,5500000,0,5500000,725000,75000
9,Texas,Big 12,2017,Tom Herman,5486316,0,5486316,725000,0
9,Texas,Big 12,2016,Charlie Strong,5200000,130,5200130,1006000,0
9,Texas,Big 12,2015,Charlie Strong,5100000,270,5100270,1003000,25000
9,Texas,Big 12,2014,Charlie Strong,5000000,270,5000270,1000000,0
9,Texas,Big 12,2013,Mack Brown,5392500,61250,5453750,850000,0
9,Texas,Big 12,2012,Mack Brown,5292500,61250,5353750,850000,0
9,Texas,Big 12,2011,Mack Brown,5192500,1000,5193500,850000,0
9,Texas,Big 12,2010,Mack Brown,5100000,61500,5161500,850000,0
9,Texas,Big 12,2009,Mack Brown,1540000,1520500,3060500,850000,0
9,Texas,Big 12,2007,Mack Brown,1291000,1460000,2751000,325000,0
9,Texas,Big 12,2006,Mack Brown,1084000,1580000,2664000,325000,0
13,Illinois,Big Ten,2018,Lovie Smith,5000000,0,5000000,1000000,50000
13,Illinois,Big Ten,2017,Lovie Smith,3000000,0,3000000,1000000,75000
13,Illinois,Big Ten,2016,Lovie Smith,1809179,0,1809179,1000000,0
13,Illinois,Big Ten,2015,Bill Cubit,915000,1010,916010,51500,0
13,Illinois,Big Ten,2014,Tim Beckman,1950000,250,1950250,80000,0
13,Illinois,Big Ten,2013,Tim Beckman,1700000,0,1700000,80000,0
13,Illinois,Big Ten,2012,Tim Beckman,1600000,0,1600000,80000,0
13,Illinois,Big Ten,2011,Ron Zook,1750000,3500,1753500,65650,0
13,Illinois,Big Ten,2010,Ron Zook,1505000,3500,1508500,52650,0
13,Illinois,Big Ten,2009,Ron Zook,605000,900000,1505000,52650,0
13,Illinois,Big Ten,2007,Ron Zook,305000,750000,1055000,26650,0
13,Illinois,Big Ten,2006,Ron Zook,530000,711750,1241750,28600,0
28,Utah,Pac-12,2018,Kyle Whittingham,3787917,0,3787917,935000,279167
28,Utah,Pac-12,2017,Kyle Whittingham,3687917,0,3687917,935000,330833
28,Utah,Pac-12,2016,Kyle Whittingham,3650000,0,3650000,935000,334167
28,Utah,Pac-12,2015,Kyle Whittingham,2600000,0,2600000,935000,195000
28,Utah,Pac-12,2014,Kyle Whittingham,2200000,0,2200000,740000,0
28,Utah,Pac-12,2013,Kyle Whittingham,2427100,0,2427100,740000,0
28,Utah,Pac-12,2012,Kyle Whittingham,2000000,0,2000000,740000,0
28,Utah,Pac-12,2011,Kyle Whittingham,1700000,0,1700000,740000,0
28,Utah,Pac-12,2010,Kyle Whittingham,1175000,0,1175000,485000,0
28,Utah,Pac-12,2009,Kyle Whittingham,270000,937500,1207500,485000,0
28,Utah,Pac-12,2007,Kyle Whittingham,211120,467000,678120,350000,0
28,Utah,Pac-12,2006,Kyle Whittingham,205000,467000,672000,280000,0
27,Purdue,Big Ten,2018,Jeff Brohm,3800000,0,3800000,1290000,180000
27,Purdue,Big Ten,2017,Jeff Brohm,3333333,0,3333333,1200000,0
27,Purdue,Big Ten,2016,Darrell Hazell,2190000,0,2190000,1545000,120000
27,Purdue,Big Ten,2015,Darrell Hazell,2140000,0,2140000,1545000,90000
27,Purdue,Big Ten,2014,Darrell Hazell,2090000,0,2090000,1545000,0
27,Purdue,Big Ten,2013,Darrell Hazell,2160833,0,2160833,1095000,0
27,Purdue,Big Ten,2012,Danny Hope,970000,0,970000,778904,0
27,Purdue,Big Ten,2011,Danny Hope,925000,0,925000,725738,0
27,Purdue,Big Ten,2010,Danny Hope,900000,0,900000,637250,0
27,Purdue,Big Ten,2009,Danny Hope,490000,335000,825000,558900,0
27,Purdue,Big Ten,2007,Joe Tiller,242550,1522256,1764806,0,0
27,Purdue,Big Ten,2006,Joe Tiller,231000,986742,1217742,0,0
40,UCLA,Pac-12,2018,Chip Kelly,3300000,0,3300000,1085000,0
40,UCLA,Pac-12,2017,Jim Mora,3550000,0,3550000,1065000,95000
40,UCLA,Pac-12,2016,Jim Mora,3450000,0,3450000,1065000,120000
40,UCLA,Pac-12,2015,Jim Mora,3350000,0,3350000,930000,145000
40,UCLA,Pac-12,2014,Jim Mora,3250000,0,3250000,930000,0
40,UCLA,Pac-12,2013,Jim Mora,2300000,0,2300000,750000,0
40,UCLA,Pac-12,2012,Jim Mora,1935000,0,1935000,750000,0
40,UCLA,Pac-12,2011,Rick Neuheisel,1250000,35000,1285000,500000,0
40,UCLA,Pac-12,2010,Rick Neuheisel,1250000,26000,1276000,500000,0
40,UCLA,Pac-12,2009,Rick Neuheisel,250000,1026000,1276000,500000,0
40,UCLA,Pac-12,2007,Karl Dorrell,150000,700000,850000,505000,0
40,UCLA,Pac-12,2006,Karl Dorrell,181000,700000,881000,505000,0
51,Duke,ACC,2018,David Cutcliffe,2540928,0,2540928,0,0
51,Duke,ACC,2017,David Cutcliffe,2613638,0,2613638,0,0
51,Duke,ACC,2016,David Cutcliffe,2320773,0,2320773,0,0
51,Duke,ACC,2015,David Cutcliffe,2049055,0,2049055,0,0
51,Duke,ACC,2014,David Cutcliffe,1840341,0,1840341,0,0
51,Duke,ACC,2013,David Cutcliffe,1792285,0,1792285,0,0
51,Duke,ACC,2012,David Cutcliffe,1788523,0,1788523,0,0
51,Duke,ACC,2011,David Cutcliffe,1762895,0,1762895,0,0
51,Duke,ACC,2010,David Cutcliffe,1581903,0,1581903,0,0
51,Duke,ACC,2009,David Cutcliffe,0,0,0,0,0
51,Duke,ACC,2007,Ted Roof,544286,0,544286,0,0
51,Duke,ACC,2006,Ted Roof,370200,0,370200,0,0
58,Navy,AAC,2018,Ken Niumatalolo,2163000,0,2163000,0,0
58,Navy,AAC,2017,Ken Niumatalolo,2000000,0,2000000,0,0
58,Navy,AAC,2016,Ken Niumatalolo,2000000,0,2000000,0,0
58,Navy,AAC,2015,Ken Niumatalolo,1637803,0,1637803,0,0
58,Navy,AAC,2014,Ken Niumatalolo,1574810,0,1574810,0,0
58,Navy,AAC,2013,Ken Niumatalolo,1514240,0,1514240,0,0
58,Navy,AAC,2012,Ken Niumatalolo,1605370,0,1605370,0,0
58,Navy,AAC,2011,Ken Niumatalolo,1538190,0,1538190,0,0
58,Navy,AAC,2010,Ken Niumatalolo,1852868,0,1852868,0,0
58,Navy,AAC,2009,Ken Niumatalolo,468464,0,468464,0,0
58,Navy,AAC,2007,Paul Johnson,1049311,0,1049311,0,0
58,Navy,AAC,2006,Paul Johnson,1003309,0,1003309,0,0
71,Tulane,AAC,2018,Willie Fritz,1629000,0,1629000,0,0
71,Tulane,AAC,2017,Willie Fritz,0,0,0,0,0
71,Tulane,AAC,2016,Willie Fritz,0,0,0,0,0
71,Tulane,AAC,2015,Curtis Johnson,926000,0,926000,0,0
71,Tulane,AAC,2014,Curtis Johnson,867000,0,867000,0,0
71,Tulane,AAC,2013,Curtis Johnson,0,0,0,0,0
71,Tulane,AAC,2012,Curtis Johnson,0,0,0,0,0
71,Tulane,AAC,2011,Bob Toledo,0,0,0,0,0
71,Tulane,AAC,2010,Bob Toledo,0,0,0,0,0
71,Tulane,AAC,2009,Bob Toledo,0,0,0,0,0
71,Tulane,AAC,2007,Bob Toledo,0,0,0,0,0
71,Tulane,AAC,2006,Chris Scelfo,0,0,0,0,0
73,Tulsa,AAC,2018,Philip Montgomery,1518177,0,1518177,0,0
73,Tulsa,AAC,2017,Philip Montgomery,1398038,0,1398038,0,0
73,Tulsa,AAC,2016,Philip Montgomery,0,0,0,0,0
73,Tulsa,AAC,2015,Philip Montgomery,0,0,0,0,0
73,Tulsa,AAC,2014,Bill Blankenship,759436,0,759436,0,0
73,Tulsa,AAC,2013,Bill Blankenship,619549,0,619549,0,0
73,Tulsa,AAC,2012,Bill Blankenship,0,0,0,0,0
73,Tulsa,AAC,2011,Bill Blankenship,0,0,0,0,0
73,Tulsa,AAC,2010,Todd Graham,804253,0,804253,0,0
73,Tulsa,AAC,2009,Todd Graham,769264,0,769264,0,0
73,Tulsa,AAC,2007,Todd Graham,0,0,0,0,0
73,Tulsa,AAC,2006,Steve Kragthorpe,438533,0,438533,0,0
77,Toledo,MAC,2018,Jason Candle,1125000,0,1125000,585000,210000
77,Toledo,MAC,2017,Jason Candle,700000,950,700950,615000,57500
77,Toledo,MAC,2016,Jason Candle,675000,0,675000,602500,0
77,Toledo,MAC,2015,Matt Campbell,495000,1450,496450,450000,137500
77,Toledo,MAC,2014,Matt Campbell,470500,12037,482537,450000,0
77,Toledo,MAC,2013,Matt Campbell,455000,2500,457500,400000,0
77,Toledo,MAC,2012,Matt Campbell,360000,450,360450,305000,0
77,Toledo,MAC,2011,Tim Beckman,409000,2540,411540,280000,0
77,Toledo,MAC,2010,Tim Beckman,370000,0,370000,256000,0
77,Toledo,MAC,2009,Tim Beckman,235000,125000,360000,255500,0
77,Toledo,MAC,2007,Tom Amstutz,195000,118300,313300,227000,0
77,Toledo,MAC,2006,Tom Amstutz,185000,191400,376400,212000,0
80,Connecticut,AAC,2018,Randy Edsall,1100000,0,1100000,650000,129000
80,Connecticut,AAC,2017,Randy Edsall,1000000,0,1000000,650000,0
80,Connecticut,AAC,2016,Bob Diaco,1700000,0,1700000,450000,33333
80,Connecticut,AAC,2015,Bob Diaco,1550000,0,1550000,450000,0
80,Connecticut,AAC,2014,Bob Diaco,1500000,0,1500000,450000,0
80,Connecticut,AAC,2013,Paul Pasqualoni,1700000,0,1700000,116666,0
80,Connecticut,AAC,2012,Paul Pasqualoni,1600000,0,1600000,115625,0
80,Connecticut,AAC,2011,Paul Pasqualoni,1500000,0,1500000,114583,0
80,Connecticut,AAC,2010,Randy Edsall,1550000,0,1550000,114583,0
80,Connecticut,AAC,2009,Randy Edsall,325000,1125000,1450000,113542,0
80,Connecticut,AAC,2007,Randy Edsall,275000,645000,920000,68751,0
80,Connecticut,AAC,2006,Randy Edsall,250000,595000,845000,0,0
81,Florida Atlantic,C-USA,2018,Lane Kiffin,1000000,0,1000000,1150000,40000
81,Florida Atlantic,C-USA,2017,Lane Kiffin,950000,0,950000,350000,0
81,Florida Atlantic,C-USA,2016,Charlie Partridge,591250,0,591250,100000,5000
81,Florida Atlantic,C-USA,2015,Charlie Partridge,525000,500,525500,100000,0
81,Florida Atlantic,C-USA,2014,Charlie Partridge,500000,0,500000,100000,0
81,Florida Atlantic,C-USA,2013,Carl Pelini,496124,1100,497224,317500,0
81,Florida Atlantic,C-USA,2012,Carl Pelini,450000,0,450000,317500,0
81,Florida Atlantic,C-USA,2011,Howard Schnellenberger,400405,5500,405905,115000,0
81,Florida Atlantic,C-USA,2010,Howard Schnellenberger,400405,7500,407905,115000,0
81,Florida Atlantic,C-USA,2009,Howard Schnellenberger,381338,2000,383338,115000,0
81,Florida Atlantic,C-USA,2007,Howard Schnellenberger,330163,1000,331163,0,0
81,Florida Atlantic,C-USA,2006,Howard Schnellenberger,350147,3000,353147,0,0
82,South Florida,AAC,2018,Charlie Strong,1000000,0,1000000,815000,70000
82,South Florida,AAC,2017,Charlie Strong,1000000,0,1000000,815000,0
82,South Florida,AAC,2016,Willie Taggart,1700000,4000,1704000,900000,25000
82,South Florida,AAC,2015,Willie Taggart,1150000,2500,1152500,650000,0
82,South Florida,AAC,2014,Willie Taggart,1150000,32000,1182000,650000,0
82,South Florida,AAC,2013,Willie Taggart,1807745,0,1807745,650000,0
82,South Florida,AAC,2012,Skip Holtz,2000000,0,2000000,650000,0
82,South Florida,AAC,2011,Skip Holtz,1700000,0,1700000,350000,0
82,South Florida,AAC,2010,Skip Holtz,1700000,0,1700000,350000,0
82,South Florida,AAC,2009,Jim Leavitt,750000,850000,1600000,350000,0
82,South Florida,AAC,2007,Jim Leavitt,675000,325000,1000000,175000,0
82,South Florida,AAC,2006,Jim Leavitt,725000,392500,1117500,175000,0
83,Liberty,Ind.,2018,Turner Gill,947281,0,947281,0,0
84,Florida International,C-USA,2018,Butch Davis,945000,0,945000,550000,35000
84,Florida International,C-USA,2017,Butch Davis,900000,0,900000,550000,0
84,Florida International,C-USA,2016,Ron Turner,609731,1000,610731,150000,25000
84,Florida International,C-USA,2015,Ron Turner,604190,1000,605190,150000,0
84,Florida International,C-USA,2014,Ron Turner,550000,1000,551000,150000,0
84,Florida International,C-USA,2013,Ron Turner,500000,0,500000,120000,0
84,Florida International,C-USA,2012,Mario Cristobal,522183,0,522183,145000,0
84,Florida International,C-USA,2011,Mario Cristobal,497183,0,497183,50000,0
84,Florida International,C-USA,2010,Mario Cristobal,437382,0,437382,50000,0
84,Florida International,C-USA,2009,Mario Cristobal,403000,0,403000,50000,0
84,Florida International,C-USA,2007,Mario Cristobal,381076,0,381076,50000,0
84,Florida International,C-USA,2006,Don Strock,250000,32100,282100,0,0
85,Utah State,Mt. West,2018,Matt Wells,900000,0,900000,765000,65000
85,Utah State,Mt. West,2017,Matt Wells,1050000,0,1050000,730000,10000
85,Utah State,Mt. West,2016,Matt Wells,800000,0,800000,730000,60000
85,Utah State,Mt. West,2015,Matt Wells,750000,2900,752900,770000,65000
85,Utah State,Mt. West,2014,Matt Wells,575000,1434,576434,765000,0
85,Utah State,Mt. West,2013,Matt Wells,500000,2500,502500,735000,0
85,Utah State,Mt. West,2012,Gary Andersen,415000,0,415000,150000,0
85,Utah State,Mt. West,2011,Gary Andersen,352400,2000,354400,45000,0
85,Utah State,Mt. West,2010,Gary Andersen,352400,2000,354400,45000,0
85,Utah State,Mt. West,2009,Gary Andersen,302400,50000,352400,45000,0
85,Utah State,Mt. West,2007,Brent Guy,226044,23500,249544,26837,0
85,Utah State,Mt. West,2006,Brent Guy,218400,23500,241900,26200,0
86,Alabama at Birmingham,C-USA,2018,Bill Clark,900000,0,900000,950000,165471
86,Alabama at Birmingham,C-USA,2017,Bill Clark,630000,0,630000,685000,0
86,Alabama at Birmingham,C-USA,2014,Bill Clark,500000,0,500000,430000,0
86,Alabama at Birmingham,C-USA,2013,Garrick McGee,550000,0,550000,330000,0
86,Alabama at Birmingham,C-USA,2012,Garrick McGee,550000,0,550000,465000,0
86,Alabama at Birmingham,C-USA,2011,Neil Callaway,443000,3800,446800,305000,0
86,Alabama at Birmingham,C-USA,2010,Neil Callaway,378000,3800,381800,305000,0
86,Alabama at Birmingham,C-USA,2009,Neil Callaway,335000,68800,403800,275000,0
86,Alabama at Birmingham,C-USA,2007,Neil Callaway,306508,60000,366508,275000,0
86,Alabama at Birmingham,C-USA,2006,Watson Brown,360000,11500,371500,0,0
87,San Diego State,Mt. West,2018,Rocky Long,872576,1000,873576,720000,95000
87,San Diego State,Mt. West,2017,Rocky Long,826304,2000,828304,735000,198150
87,San Diego State,Mt. West,2016,Rocky Long,810632,0,810632,655000,195000
87,San Diego State,Mt. West,2015,Rocky Long,806300,2000,808300,655000,65000
87,San Diego State,Mt. West,2014,Rocky Long,800000,2000,802000,855000,0
87,San Diego State,Mt. West,2013,Rocky Long,800000,0,800000,855000,0
87,San Diego State,Mt. West,2012,Rocky Long,800000,2600,802600,805000,0
87,San Diego State,Mt. West,2011,Rocky Long,800000,1000,801000,855000,0
87,San Diego State,Mt. West,2010,Brady Hoke,675000,0,675000,700000,0
87,San Diego State,Mt. West,2009,Brady Hoke,675000,1800,676800,900000,0
87,San Diego State,Mt. West,2007,Chuck Long,210900,506000,716900,125000,0
87,San Diego State,Mt. West,2006,Chuck Long,700000,1500,701500,300000,0
88,Louisiana-Lafayette,Sun Belt,2018,Billy Napier,850000,0,850000,435000,0
88,Louisiana-Lafayette,Sun Belt,2017,Mark Hudspeth,1150000,0,1150000,155000,25000
88,Louisiana-Lafayette,Sun Belt,2016,Mark Hudspeth,1100000,0,1100000,155000,0
88,Louisiana-Lafayette,Sun Belt,2015,Mark Hudspeth,1050000,3156,1053156,155000,45000
88,Louisiana-Lafayette,Sun Belt,2014,Mark Hudspeth,1000000,3156,1003156,155000,0
88,Louisiana-Lafayette,Sun Belt,2013,Mark Hudspeth,800000,3000,803000,105000,0
88,Louisiana-Lafayette,Sun Belt,2012,Mark Hudspeth,800000,3000,803000,105000,0
88,Louisiana-Lafayette,Sun Belt,2011,Mark Hudspeth,360000,1000,361000,65000,0
88,Louisiana-Lafayette,Sun Belt,2010,Rickey Bustle,225000,1000,226000,47500,0
88,Louisiana-Lafayette,Sun Belt,2009,Rickey Bustle,166760,59240,226000,37794,0
88,Louisiana-Lafayette,Sun Belt,2007,Rickey Bustle,160750,35000,195750,42375,0
88,Louisiana-Lafayette,Sun Belt,2006,Rickey Bustle,194250,0,194250,25417,0
89,Arkansas State,Sun Belt,2018,Blake Anderson,825000,0,825000,185000,25000
89,Arkansas State,Sun Belt,2017,Blake Anderson,750000,0,750000,185000,50000
89,Arkansas State,Sun Belt,2016,Blake Anderson,700000,0,700000,235000,50000
89,Arkansas State,Sun Belt,2015,Blake Anderson,700000,0,700000,235000,25000
89,Arkansas State,Sun Belt,2014,Blake Anderson,700000,0,700000,235000,0
89,Arkansas State,Sun Belt,2013,Bryan Harsin,724597,0,724597,245000,0
89,Arkansas State,Sun Belt,2012,Gus Malzahn,856210,3400,859610,160000,0
89,Arkansas State,Sun Belt,2011,Hugh Freeze,151660,50500,202160,22500,0
89,Arkansas State,Sun Belt,2010,Steve Roberts,140000,83078,223078,0,0
89,Arkansas State,Sun Belt,2009,Steve Roberts,140000,80162,220162,0,0
89,Arkansas State,Sun Belt,2007,Steve Roberts,140000,31042,171042,0,0
89,Arkansas State,Sun Belt,2006,Steve Roberts,140000,49655,189655,0,0
90,New Mexico,Mt. West,2018,Bob Davie,822690,1050,823740,340000,0
90,New Mexico,Mt. West,2017,Bob Davie,822690,1250,823940,490000,20000
90,New Mexico,Mt. West,2016,Bob Davie,822690,1250,823940,490000,20000
90,New Mexico,Mt. West,2015,Bob Davie,772690,1250,773940,490000,0
90,New Mexico,Mt. West,2014,Bob Davie,772690,11000,783690,480000,0
90,New Mexico,Mt. West,2013,Bob Davie,763600,0,763600,330000,0
90,New Mexico,Mt. West,2012,Bob Davie,760000,0,760000,350000,0
90,New Mexico,Mt. West,2011,Mike Locksley,750000,10500,760500,315000,0
90,New Mexico,Mt. West,2010,Mike Locksley,750000,10500,760500,265000,0
90,New Mexico,Mt. West,2009,Mike Locksley,300000,450650,750650,265000,0
90,New Mexico,Mt. West,2007,Rocky Long,364513,75000,439513,0,0
90,New Mexico,Mt. West,2006,Rocky Long,356175,75000,431175,0,0
91,Troy,Sun Belt,2018,Neal Brown,810000,0,810000,490000,100000
91,Troy,Sun Belt,2017,Neal Brown,800000,0,800000,490000,80000
91,Troy,Sun Belt,2016,Neal Brown,660000,0,660000,490000,0
91,Troy,Sun Belt,2015,Neal Brown,660000,0,660000,475000,0
91,Troy,Sun Belt,2014,Larry Blakeney,518788,0,518788,77500,0
91,Troy,Sun Belt,2013,Larry Blakeney,480000,1000,481000,67500,0
91,Troy,Sun Belt,2012,Larry Blakeney,455000,0,455000,75000,0
91,Troy,Sun Belt,2011,Larry Blakeney,380000,1000,381000,75000,0
91,Troy,Sun Belt,2010,Larry Blakeney,355000,1000,356000,75000,0
91,Troy,Sun Belt,2009,Larry Blakeney,269899,51000,320899,22500,0
91,Troy,Sun Belt,2007,Larry Blakeney,237038,51000,288038,22500,0
91,Troy,Sun Belt,2006,Larry Blakeney,225750,1000,226750,22500,0
92,Western Kentucky,C-USA,2018,Mike Sanford Jr.,800000,5850,805850,400000,0
92,Western Kentucky,C-USA,2017,Mike Sanford Jr.,800000,0,800000,400000,0
92,Western Kentucky,C-USA,2016,Jeff Brohm,805600,3120,808720,450000,150000
92,Western Kentucky,C-USA,2015,Jeff Brohm,610800,3120,613920,450000,100000
92,Western Kentucky,C-USA,2014,Jeff Brohm,600000,0,600000,550000,0
92,Western Kentucky,C-USA,2013,Bobby Petrino,855600,0,855600,355000,0
92,Western Kentucky,C-USA,2012,Willie Taggart,475000,4800,479800,168750,0
92,Western Kentucky,C-USA,2011,Willie Taggart,225000,0,225000,144750,0
92,Western Kentucky,C-USA,2010,Willie Taggart,225000,0,225000,144750,0
92,Western Kentucky,C-USA,2009,David Elson,250008,9800,259808,152838,0
92,Western Kentucky,C-USA,2007,David Elson,175000,4600,179600,94498,0
93,Middle Tennessee,C-USA,2018,Rick Stockstill,801504,1500,803004,126142,65142
93,Middle Tennessee,C-USA,2017,Rick Stockstill,801504,0,801504,126142,65142
93,Middle Tennessee,C-USA,2016,Rick Stockstill,801504,2500,804004,126142,65142
93,Middle Tennessee,C-USA,2015,Rick Stockstill,801504,10500,812004,126142,5000
93,Middle Tennessee,C-USA,2014,Rick Stockstill,801504,1625,803129,126142,0
93,Middle Tennessee,C-USA,2013,Rick Stockstill,701504,2500,704004,157809,0
93,Middle Tennessee,C-USA,2012,Rick Stockstill,601504,625,602129,149475,0
93,Middle Tennessee,C-USA,2011,Rick Stockstill,588780,625,589405,148415,0
93,Middle Tennessee,C-USA,2010,Rick Stockstill,488955,2625,491580,111000,0
93,Middle Tennessee,C-USA,2009,Rick Stockstill,195155,86500,281655,112180,0
93,Middle Tennessee,C-USA,2007,Rick Stockstill,207955,75000,282955,75000,0
93,Middle Tennessee,C-USA,2006,Rick Stockstill,179800,75000,254800,130583,0
94,Western Michigan,MAC,2018,Tim Lester,800000,0,800000,346500,39250
94,Western Michigan,MAC,2017,Tim Lester,800000,0,800000,322000,0
94,Western Michigan,MAC,2016,P.J. Fleck,816360,4000,820360,336000,128500
94,Western Michigan,MAC,2015,P.J. Fleck,800000,2500,802500,336000,78750
94,Western Michigan,MAC,2014,P.J. Fleck,392500,0,392500,236000,0
94,Western Michigan,MAC,2013,P.J. Fleck,392500,0,392500,236000,0
94,Western Michigan,MAC,2012,Bill Cubit,377250,2000,379250,251500,0
94,Western Michigan,MAC,2011,Bill Cubit,377250,2000,379250,251500,0
94,Western Michigan,MAC,2010,Bill Cubit,375000,2000,377000,251500,0
94,Western Michigan,MAC,2009,Bill Cubit,225000,154000,379000,223000,0
94,Western Michigan,MAC,2007,Bill Cubit,191000,75000,266000,222000,0
94,Western Michigan,MAC,2006,Bill Cubit,165000,23000,188000,21450,0
95,Marshall,C-USA,2018,Doc Holliday,762570,0,762570,145000,55000
95,Marshall,C-USA,2017,Doc Holliday,762570,0,762570,145000,25000
95,Marshall,C-USA,2016,Doc Holliday,762570,2750,765320,145000,55000
95,Marshall,C-USA,2015,Doc Holliday,755500,2750,758250,145000,95000
95,Marshall,C-USA,2014,Doc Holliday,607070,2750,609820,115000,0
95,Marshall,C-USA,2013,Doc Holliday,607070,14250,621320,80000,0
95,Marshall,C-USA,2012,Doc Holliday,600000,12750,612750,80000,0
95,Marshall,C-USA,2011,Doc Holliday,607070,12750,619820,80000,0
95,Marshall,C-USA,2010,Doc Holliday,600000,17750,617750,80000,0
95,Marshall,C-USA,2009,Mark Snyder,187056,180739,367795,80000,0
95,Marshall,C-USA,2007,Mark Snyder,294977,175936,470913,80000,0
95,Marshall,C-USA,2006,Mark Snyder,144200,246403,390603,130000,0
96,Appalachian State,Sun Belt,2018,Scott Satterfield,712500,0,712500,295000,145000
96,Appalachian State,Sun Belt,2017,Scott Satterfield,675000,0,675000,270000,155000
96,Appalachian State,Sun Belt,2016,Scott Satterfield,525000,0,525000,290000,30000
96,Appalachian State,Sun Belt,2015,Scott Satterfield,375000,0,375000,165000,27500
96,Appalachian State,Sun Belt,2014,Scott Satterfield,225000,0,225000,25000,0
97,Louisiana Tech,C-USA,2018,Skip Holtz,700000,0,700000,395000,0
97,Louisiana Tech,C-USA,2017,Skip Holtz,700000,4000,704000,395000,50000
97,Louisiana Tech,C-USA,2016,Skip Holtz,500000,15000,515000,295000,25000
97,Louisiana Tech,C-USA,2015,Skip Holtz,500000,17000,517000,295000,25000
97,Louisiana Tech,C-USA,2014,Skip Holtz,500000,10000,510000,295000,0
97,Louisiana Tech,C-USA,2013,Skip Holtz,500000,10000,510000,295000,0
97,Louisiana Tech,C-USA,2012,Sonny Dykes,750000,10200,760200,310000,0
97,Louisiana Tech,C-USA,2011,Sonny Dykes,450000,10500,460500,310000,0
97,Louisiana Tech,C-USA,2010,Sonny Dykes,450000,0,450000,310000,0
97,Louisiana Tech,C-USA,2009,Derek Dooley,200000,205000,405000,110000,0
97,Louisiana Tech,C-USA,2007,Derek Dooley,200000,150000,350000,100000,0
97,Louisiana Tech,C-USA,2006,Jack Bicknell III,150000,58500,208500,0,0
98,Texas-El Paso,C-USA,2018,Dana Dimel,700000,0,700000,741665,0
98,Texas-El Paso,C-USA,2017,Sean Kugler,515332,0,515332,493776,24611
98,Texas-El Paso,C-USA,2016,Sean Kugler,515332,0,515332,493776,24128
98,Texas-El Paso,C-USA,2015,Sean Kugler,509541,4500,514041,486052,75044
98,Texas-El Paso,C-USA,2014,Sean Kugler,503864,4500,508364,478481,0
98,Texas-El Paso,C-USA,2013,Sean Kugler,500000,0,500000,449999,0
98,Texas-El Paso,C-USA,2012,Mike Price,359206,9000,368206,320853,0
98,Texas-El Paso,C-USA,2011,Mike Price,383706,10000,393706,320853,0
98,Texas-El Paso,C-USA,2010,Mike Price,383346,11500,394846,320853,0
98,Texas-El Paso,C-USA,2009,Mike Price,428666,60000,488666,323167,0
98,Texas-El Paso,C-USA,2007,Mike Price,410000,50000,460000,349998,0
98,Texas-El Paso,C-USA,2006,Mike Price,483500,59500,543000,263334,0
99,Texas State,Sun Belt,2018,Everett Withers,700000,0,700000,70833,0
99,Texas State,Sun Belt,2017,Everett Withers,675000,0,675000,68750,0
99,Texas State,Sun Belt,2016,Everett Withers,650000,0,650000,66667,0
99,Texas State,Sun Belt,2015,Dennis Franchione,425000,2000,427000,232500,7500
99,Texas State,Sun Belt,2014,Dennis Franchione,400000,1200,401200,232500,0
99,Texas State,Sun Belt,2013,Dennis Franchione,366075,7300,373375,132500,0
99,Texas State,Sun Belt,2012,Dennis Franchione,360500,2300,362800,57500,0
100,Central Michigan,MAC,2018,John Bonamego,655000,0,655000,415000,45000
100,Central Michigan,MAC,2017,John Bonamego,545640,0,545640,330000,35500
100,Central Michigan,MAC,2016,John Bonamego,545640,300,545940,320000,43500
100,Central Michigan,MAC,2015,John Bonamego,533500,0,533500,330000,0
100,Central Michigan,MAC,2014,Dan Enos,360000,0,360000,305000,0
100,Central Michigan,MAC,2013,Dan Enos,360000,600,360600,224000,0
100,Central Michigan,MAC,2012,Dan Enos,325000,600,325600,133000,0
100,Central Michigan,MAC,2011,Dan Enos,325000,600,325600,125500,0
100,Central Michigan,MAC,2010,Dan Enos,350000,0,350000,125500,0
100,Central Michigan,MAC,2009,Butch Jones,277950,30500,308450,237500,0
100,Central Michigan,MAC,2007,Butch Jones,200850,65000,265850,140000,0
100,Central Michigan,MAC,2006,Brian Kelly,159397,25500,184897,14500,0
101,Old Dominion,C-USA,2018,Bobby Wilder,654667,0,654667,504895,0
101,Old Dominion,C-USA,2017,Bobby Wilder,650000,0,650000,504506,10000
101,Old Dominion,C-USA,2016,Bobby Wilder,554590,15000,569590,504506,0
101,Old Dominion,C-USA,2015,Bobby Wilder,550000,15000,565000,504125,0
101,Old Dominion,C-USA,2014,Bobby Wilder,475000,11010,486010,503333,0
101,Old Dominion,C-USA,2013,Bobby Wilder,450000,0,450000,0,0
102,Georgia Southern,Sun Belt,2018,Chad Lunsford,650000,0,650000,295000,0
102,Georgia Southern,Sun Belt,2017,Tyson Summers,530000,0,530000,292500,0
102,Georgia Southern,Sun Belt,2016,Tyson Summers,500000,0,500000,292500,0
102,Georgia Southern,Sun Belt,2015,Willie Fritz,500000,0,500000,287500,35000
102,Georgia Southern,Sun Belt,2014,Willie Fritz,400000,0,400000,42500,0
103,Northern Illinois,MAC,2018,Rod Carey,633460,0,633460,205000,42500
103,Northern Illinois,MAC,2017,Rod Carey,623000,0,623000,205000,17500
103,Northern Illinois,MAC,2016,Rod Carey,623000,2500,625500,205000,52500
103,Northern Illinois,MAC,2015,Rod Carey,400000,1500,401500,205000,77500
103,Northern Illinois,MAC,2014,Rod Carey,400000,1500,401500,205000,0
103,Northern Illinois,MAC,2013,Rod Carey,375000,1000,376000,205000,0
103,Northern Illinois,MAC,2012,Dave Doeren,420000,3000,423000,205000,0
103,Northern Illinois,MAC,2011,Dave Doeren,371000,0,371000,205000,0
103,Northern Illinois,MAC,2010,Jerry Kill,346812,1000,347812,205000,0
103,Northern Illinois,MAC,2009,Jerry Kill,340000,4773,344773,205000,0
103,Northern Illinois,MAC,2007,Joe Novak,305136,0,305136,0,0
103,Northern Illinois,MAC,2006,Joe Novak,212496,0,212496,0,0
104,Charlotte,C-USA,2018,Brad Lambert,625000,0,625000,120000,0
104,Charlotte,C-USA,2017,Brad Lambert,625000,0,625000,120000,0
104,Charlotte,C-USA,2016,Brad Lambert,600000,0,600000,120000,0
104,Charlotte,C-USA,2015,Brad Lambert,600000,0,600000,120000,0
105,South Alabama,Sun Belt,2018,Steve Campbell,600000,0,600000,295000,0
105,South Alabama,Sun Belt,2017,Joey Jones,535260,30000,565260,183869,42704
105,South Alabama,Sun Belt,2016,Joey Jones,525000,35000,560000,211025,5000
105,South Alabama,Sun Belt,2015,Joey Jones,525000,35500,560500,211025,31438
105,South Alabama,Sun Belt,2014,Joey Jones,435000,36000,471000,171000,0
105,South Alabama,Sun Belt,2013,Joey Jones,358450,26000,384450,38871,0
105,South Alabama,Sun Belt,2012,Joey Jones,345125,26000,371125,50625,0
106,Nevada-Las Vegas,Mt. West,2018,Tony Sanchez,600000,0,600000,260000,0
106,Nevada-Las Vegas,Mt. West,2017,Tony Sanchez,600000,0,600000,260000,30000
106,Nevada-Las Vegas,Mt. West,2016,Tony Sanchez,510000,0,510000,325000,15000
106,Nevada-Las Vegas,Mt. West,2015,Tony Sanchez,560000,0,560000,175000,0
106,Nevada-Las Vegas,Mt. West,2014,Bobby Hauck,850000,0,850000,285000,0
106,Nevada-Las Vegas,Mt. West,2013,Bobby Hauck,500000,3749,503749,140000,0
106,Nevada-Las Vegas,Mt. West,2012,Bobby Hauck,500000,900,500900,140000,0
106,Nevada-Las Vegas,Mt. West,2011,Bobby Hauck,500000,1100,501100,140000,0
106,Nevada-Las Vegas,Mt. West,2010,Bobby Hauck,500000,2500,502500,140000,0
106,Nevada-Las Vegas,Mt. West,2009,Mike Sanford,160000,283100,443100,110000,0
106,Nevada-Las Vegas,Mt. West,2007,Mike Sanford,160000,279000,439000,50000,0
106,Nevada-Las Vegas,Mt. West,2006,Mike Sanford,160000,275000,435000,50000,0
107,San Jose State,Mt. West,2018,Brent Brennan,590424,0,590424,210000,0
107,San Jose State,Mt. West,2017,Brent Brennan,581916,0,581916,210000,0
107,San Jose State,Mt. West,2016,Ron Caragher,546745,0,546745,195000,10000
107,San Jose State,Mt. West,2015,Ron Caragher,540745,30,540775,195000,5000
107,San Jose State,Mt. West,2014,Ron Caragher,525000,0,525000,195000,0
107,San Jose State,Mt. West,2013,Ron Caragher,525000,0,525000,195000,0
107,San Jose State,Mt. West,2012,Mike MacIntyre,401820,10000,411820,300835,0
107,San Jose State,Mt. West,2011,Mike MacIntyre,401820,10000,411820,300835,0
107,San Jose State,Mt. West,2010,Mike MacIntyre,401820,2000,403820,300835,0
107,San Jose State,Mt. West,2009,Dick Tomey,200004,257816,457820,73335,0
107,San Jose State,Mt. West,2007,Dick Tomey,245004,206000,451004,49167,0
107,San Jose State,Mt. West,2006,Dick Tomey,206700,135400,342100,88450,0
108,Ohio,MAC,2018,Frank Solich,580331,0,580331,333833,60772
108,Ohio,MAC,2017,Frank Solich,522715,0,522715,331930,35386
108,Ohio,MAC,2016,Frank Solich,572715,0,572715,331930,10000
108,Ohio,MAC,2015,Frank Solich,562760,1500,564260,329440,0
108,Ohio,MAC,2014,Frank Solich,553000,1500,554500,327000,0
108,Ohio,MAC,2013,Frank Solich,502400,11500,513900,299350,0
108,Ohio,MAC,2012,Frank Solich,500000,11500,511500,297500,0
108,Ohio,MAC,2011,Frank Solich,465099,11250,476349,288325,0
108,Ohio,MAC,2010,Frank Solich,458300,2500,460800,288325,0
108,Ohio,MAC,2009,Frank Solich,385000,71000,456000,287500,0
108,Ohio,MAC,2007,Frank Solich,257162,11900,269062,190006,0
108,Ohio,MAC,2006,Frank Solich,249672,12500,262172,162400,0
109,Georgia State,Sun Belt,2018,Shawn Elliott,569000,0,569000,220000,60000
109,Georgia State,Sun Belt,2017,Shawn Elliott,565000,0,565000,220000,0
109,Georgia State,Sun Belt,2016,Trent Miles,537405,2000,539405,362500,56000
109,Georgia State,Sun Belt,2015,Trent Miles,523500,4000,527500,362500,9500
109,Georgia State,Sun Belt,2014,Trent Miles,510000,0,510000,381500,0
109,Georgia State,Sun Belt,2013,Trent Miles,510000,0,510000,304500,0
110,Miami (Ohio),MAC,2018,Chuck Martin,524826,0,524826,582110,12669
110,Miami (Ohio),MAC,2017,Chuck Martin,522300,0,522300,548162,51643
110,Miami (Ohio),MAC,2016,Chuck Martin,472300,0,472300,498081,6750
110,Miami (Ohio),MAC,2015,Chuck Martin,450000,0,450000,482493,20250
110,Miami (Ohio),MAC,2014,Chuck Martin,450000,0,450000,462243,0
110,Miami (Ohio),MAC,2013,Don Treadwell,400000,0,400000,393660,0
110,Miami (Ohio),MAC,2012,Don Treadwell,410000,0,410000,421826,0
110,Miami (Ohio),MAC,2011,Don Treadwell,412000,1000,413000,405612,0
110,Miami (Ohio),MAC,2010,Michael Haywood,300000,0,300000,296496,0
110,Miami (Ohio),MAC,2009,Michael Haywood,200000,100000,300000,296441,0
110,Miami (Ohio),MAC,2007,Shane Montgomery,131325,12900,144225,91484,0
110,Miami (Ohio),MAC,2006,Shane Montgomery,127500,12000,139500,27409,0
111,Southern Mississippi,C-USA,2018,Jay Hopson,500000,0,500000,870000,15000
111,Southern Mississippi,C-USA,2017,Jay Hopson,500000,0,500000,867500,15000
111,Southern Mississippi,C-USA,2016,Jay Hopson,500000,0,500000,867500,0
111,Southern Mississippi,C-USA,2015,Todd Monken,700000,0,700000,125000,15000
111,Southern Mississippi,C-USA,2014,Todd Monken,700000,0,700000,125000,0
111,Southern Mississippi,C-USA,2013,Todd Monken,700000,1200,701200,133333,0
111,Southern Mississippi,C-USA,2012,Ellis Johnson,790000,0,790000,465000,0
111,Southern Mississippi,C-USA,2011,Larry Fedora,685000,19500,704500,387500,0
111,Southern Mississippi,C-USA,2010,Larry Fedora,685000,19500,704500,165000,0
111,Southern Mississippi,C-USA,2009,Larry Fedora,341602,394500,736102,160000,0
111,Southern Mississippi,C-USA,2007,Jeff Bower,365233,159750,524983,152000,0
111,Southern Mississippi,C-USA,2006,Jeff Bower,275233,74750,349983,274048,0
112,Massachusetts,Ind.,2018,Mark Whipple,500000,0,500000,305000,20000
112,Massachusetts,Ind.,2017,Mark Whipple,472654,250,472904,255000,0
112,Massachusetts,Ind.,2016,Mark Whipple,467965,1250,469215,295000,10000
112,Massachusetts,Ind.,2015,Mark Whipple,450000,6000,456000,200000,0
112,Massachusetts,Ind.,2014,Mark Whipple,450000,0,450000,200000,0
112,Massachusetts,Ind.,2013,Charley Molnar,417730,1200,418930,162500,0
112,Massachusetts,Ind.,2012,Charley Molnar,400625,0,400625,122500,0
113,Nevada,Mt. West,2018,Jay Norvell,500000,0,500000,210000,0
113,Nevada,Mt. West,2017,Jay Norvell,450000,0,450000,210000,0
113,Nevada,Mt. West,2016,Brian Polian,575000,3000,578000,250000,85000
113,Nevada,Mt. West,2015,Brian Polian,575000,3000,578000,250000,55000
113,Nevada,Mt. West,2014,Brian Polian,575000,0,575000,250000,0
113,Nevada,Mt. West,2013,Brian Polian,525000,0,525000,250000,0
113,Nevada,Mt. West,2012,Chris Ault,493093,0,493093,30000,0
113,Nevada,Mt. West,2011,Chris Ault,438952,0,438952,30000,0
113,Nevada,Mt. West,2010,Chris Ault,443093,0,443093,30000,0
113,Nevada,Mt. West,2009,Chris Ault,377505,0,377505,30000,0
113,Nevada,Mt. West,2007,Chris Ault,368092,0,368092,30000,0
113,Nevada,Mt. West,2006,Chris Ault,360000,0,360000,30000,0
114,Hawaii,Mt. West,2018,Nick Rolovich,425004,61500,486504,1260000,0
114,Hawaii,Mt. West,2017,Nick Rolovich,400008,2094,402102,1260000,60000
114,Hawaii,Mt. West,2016,Nick Rolovich,400008,0,400008,1260000,0
114,Hawaii,Mt. West,2015,Norm Chow,550000,87750,637750,1180000,0
114,Hawaii,Mt. West,2014,Norm Chow,550000,70500,620500,1180000,0
114,Hawaii,Mt. West,2013,Norm Chow,550000,70000,620000,880000,0
114,Hawaii,Mt. West,2012,Norm Chow,550000,0,550000,695000,0
114,Hawaii,Mt. West,2011,Greg McMackin,1100004,15000,1115004,130000,0
114,Hawaii,Mt. West,2010,Greg McMackin,1100004,13000,1113004,160000,0
114,Hawaii,Mt. West,2009,Greg McMackin,1100004,38500,1138504,130000,0
114,Hawaii,Mt. West,2007,June Jones,400008,400008,800016,130000,0
114,Hawaii,Mt. West,2006,June Jones,400008,420000,820008,130000,0
115,Eastern Michigan,MAC,2018,Chris Creighton,460000,0,460000,395000,10000
115,Eastern Michigan,MAC,2017,Chris Creighton,442420,0,442420,395000,35000
115,Eastern Michigan,MAC,2016,Chris Creighton,434840,0,434840,310000,0
115,Eastern Michigan,MAC,2015,Chris Creighton,425000,0,425000,310000,0
115,Eastern Michigan,MAC,2014,Chris Creighton,425000,0,425000,310000,0
115,Eastern Michigan,MAC,2013,Ron English,374937,0,374937,90000,0
115,Eastern Michigan,MAC,2012,Ron English,360517,0,360517,90000,0
115,Eastern Michigan,MAC,2011,Ron English,343350,0,343350,90000,0
115,Eastern Michigan,MAC,2010,Ron English,315000,1000,316000,90000,0
115,Eastern Michigan,MAC,2009,Ron English,275000,25000,300000,90000,0
115,Eastern Michigan,MAC,2007,Jeff Genyk,183000,13000,196000,86000,0
115,Eastern Michigan,MAC,2006,Jeff Genyk,141442,13000,154442,10000,0
116,Buffalo,MAC,2018,Lance Leipold,455500,0,455500,381000,0
116,Buffalo,MAC,2017,Lance Leipold,405500,0,405500,380000,0
116,Buffalo,MAC,2016,Lance Leipold,405500,0,405500,380000,0
116,Buffalo,MAC,2015,Lance Leipold,400000,0,400000,380000,0
116,Buffalo,MAC,2014,Jeff Quinn,380210,0,380210,470000,0
116,Buffalo,MAC,2013,Jeff Quinn,325000,0,325000,335000,0
116,Buffalo,MAC,2012,Jeff Quinn,325000,0,325000,330000,0
116,Buffalo,MAC,2011,Jeff Quinn,325000,0,325000,332500,0
116,Buffalo,MAC,2010,Jeff Quinn,338000,0,338000,317500,0
116,Buffalo,MAC,2009,Turner Gill,200651,200649,401300,390500,0
116,Buffalo,MAC,2007,Turner Gill,187700,3000,190700,100592,0
116,Buffalo,MAC,2006,Turner Gill,180000,3000,183000,87500,0
118,Bowling Green,MAC,2018,Mike Jinks,437228,0,437228,245000,81250
118,Bowling Green,MAC,2017,Mike Jinks,428655,0,428655,245000,25000
118,Bowling Green,MAC,2016,Mike Jinks,410000,0,410000,245000,0
118,Bowling Green,MAC,2015,Dino Babers,413000,0,413000,245000,107500
118,Bowling Green,MAC,2014,Dino Babers,405000,0,405000,130000,0
118,Bowling Green,MAC,2013,Dave Clawson,400000,1000,401000,109000,0
118,Bowling Green,MAC,2012,Dave Clawson,363000,1200,364200,116000,0
118,Bowling Green,MAC,2011,Dave Clawson,363000,1200,364200,111000,0
118,Bowling Green,MAC,2010,Dave Clawson,205000,1000,206000,98000,0
118,Bowling Green,MAC,2009,Dave Clawson,215000,86000,301000,100000,0
118,Bowling Green,MAC,2007,Gregg Brandon,163909,20000,183909,54000,0
118,Bowling Green,MAC,2006,Gregg Brandon,130000,20000,150000,50000,0
119,Ball State,MAC,2018,Mike Neu,435689,0,435689,380000,30000
119,Ball State,MAC,2017,Mike Neu,431375,5000,436375,370000,0
119,Ball State,MAC,2016,Mike Neu,425000,3500,428500,370000,0
119,Ball State,MAC,2015,Pete Lembo,514250,3500,517750,460000,2500
119,Ball State,MAC,2014,Pete Lembo,500000,3500,503500,450000,0
119,Ball State,MAC,2013,Pete Lembo,396000,3000,399000,265000,0
119,Ball State,MAC,2012,Pete Lembo,350000,2800,352800,265000,0
119,Ball State,MAC,2011,Pete Lembo,350000,300,350300,265000,0
119,Ball State,MAC,2010,Stan Parrish,350000,0,350000,250000,0
119,Ball State,MAC,2009,Stan Parrish,350000,0,350000,235000,0
119,Ball State,MAC,2007,Brady Hoke,164289,5345,169634,62500,0
119,Ball State,MAC,2006,Brady Hoke,132970,26250,159220,0,0
120,New Mexico State,WAC,2018,Doug Martin,419640,0,419640,220000,20000
120,New Mexico State,WAC,2017,Doug Martin,376044,0,376044,135000,0
120,New Mexico State,WAC,2016,Doug Martin,376044,0,376044,135000,0
120,New Mexico State,WAC,2015,Doug Martin,376044,1000,377044,135000,0
120,New Mexico State,WAC,2014,Doug Martin,376044,1000,377044,185000,0
120,New Mexico State,WAC,2013,Doug Martin,375000,0,375000,185000,0
120,New Mexico State,WAC,2012,DeWayne Walker,382260,0,382260,185000,0
120,New Mexico State,WAC,2011,DeWayne Walker,375000,0,375000,185000,0
120,New Mexico State,WAC,2010,DeWayne Walker,375000,0,375000,185000,0
120,New Mexico State,WAC,2009,DeWayne Walker,375000,0,375000,185000,0
120,New Mexico State,WAC,2007,Hal Mumme,238320,110600,348920,205000,0
120,New Mexico State,WAC,2006,Hal Mumme,229000,54800,283800,165000,0
121,Akron,MAC,2018,Terry Bowden,411000,1500,412500,225000,50000
121,Akron,MAC,2017,Terry Bowden,411000,1500,412500,225000,5000
121,Akron,MAC,2016,Terry Bowden,411000,1500,412500,225000,30000
121,Akron,MAC,2015,Terry Bowden,406000,1500,407500,255000,10000
121,Akron,MAC,2014,Terry Bowden,406000,0,406000,255000,0
121,Akron,MAC,2013,Terry Bowden,400000,0,400000,205000,0
121,Akron,MAC,2012,Terry Bowden,375000,0,375000,90000,0
121,Akron,MAC,2011,Rob Ianello,375000,0,375000,155000,0
121,Akron,MAC,2010,Rob Ianello,375000,0,375000,155000,0
121,Akron,MAC,2009,J.D. Brookhart,196292,50000,246292,248148,0
121,Akron,MAC,2007,J.D. Brookhart,188888,55000,243888,229960,0
121,Akron,MAC,2006,J.D. Brookhart,182500,25000,207500,17500,0
117,Kent State,MAC,2018,Sean Lewis,440000,0,440000,406000,0
117,Kent State,MAC,2017,Paul Haynes,414030,0,414030,173000,1000
117,Kent State,MAC,2016,Paul Haynes,405912,1000,406912,173000,12000
117,Kent State,MAC,2015,Paul Haynes,390150,2200,392350,173000,1000
117,Kent State,MAC,2014,Paul Haynes,382500,1200,383700,336000,0
117,Kent State,MAC,2013,Paul Haynes,382500,0,382500,261000,0
117,Kent State,MAC,2012,Darrell Hazell,300000,0,300000,76000,0
117,Kent State,MAC,2011,Darrell Hazell,300000,0,300000,96000,0
117,Kent State,MAC,2010,Doug Martin,190000,0,190000,91500,0
117,Kent State,MAC,2009,Doug Martin,190000,0,190000,91500,0
117,Kent State,MAC,2007,Doug Martin,170000,0,170000,84000,0
117,Kent State,MAC,2006,Doug Martin,150200,0,150200,42000,0
122,Coastal Carolina,Sun Belt,2018,Joe Moglia,400000,0,400000,800000,25000
122,Coastal Carolina,Sun Belt,2017,Joe Moglia,400000,0,400000,525000,0
123,Louisiana-Monroe,Sun Belt,2018,Matt Viator,390000,0,390000,50000,0
123,Louisiana-Monroe,Sun Belt,2017,Matt Viator,390000,0,390000,50000,0
123,Louisiana-Monroe,Sun Belt,2016,Matt Viator,390000,0,390000,50000,0
123,Louisiana-Monroe,Sun Belt,2015,Todd Berry,360000,600,360600,47500,0
123,Louisiana-Monroe,Sun Belt,2014,Todd Berry,357000,1250,358250,47500,0
123,Louisiana-Monroe,Sun Belt,2013,Todd Berry,288268,0,288268,42500,0
123,Louisiana-Monroe,Sun Belt,2012,Todd Berry,250000,0,250000,62500,0
123,Louisiana-Monroe,Sun Belt,2011,Todd Berry,225000,0,225000,62500,0
123,Louisiana-Monroe,Sun Belt,2010,Todd Berry,215000,0,215000,62500,0
123,Louisiana-Monroe,Sun Belt,2009,Charlie Weatherbie,160000,0,160000,30000,0
123,Louisiana-Monroe,Sun Belt,2007,Charlie Weatherbie,155000,50000,205000,30000,0
123,Louisiana-Monroe,Sun Belt,2006,Charlie Weatherbie,125000,5000,130000,0,0
124,Baylor,Big 12,2018,Matt Rhule,0,0,0,0,0
124,Baylor,Big 12,2017,Matt Rhule,0,0,0,0,0
124,Baylor,Big 12,2016,Jim Grobe,0,0,0,0,0
124,Baylor,Big 12,2015,Art Briles,4236073,2500,4238573,0,0
124,Baylor,Big 12,2014,Art Briles,3135146,0,3135146,0,0
124,Baylor,Big 12,2013,Art Briles,2426360,0,2426360,0,0
124,Baylor,Big 12,2012,Art Briles,2232807,0,2232807,0,0
124,Baylor,Big 12,2011,Art Briles,1549396,0,1549396,0,0
124,Baylor,Big 12,2010,Art Briles,878315,0,878315,0,0
124,Baylor,Big 12,2009,Art Briles,943830,0,943830,0,0
124,Baylor,Big 12,2007,Guy Morriss,1204818,0,1204818,0,0
124,Baylor,Big 12,2006,Guy Morriss,1144236,0,1144236,0,0
125,Air Force,Mt. West,2018,Troy Calhoun,0,0,0,0,0
125,Air Force,Mt. West,2017,Troy Calhoun,0,0,0,0,0
125,Air Force,Mt. West,2016,Troy Calhoun,885000,0,885000,0,85000
125,Air Force,Mt. West,2015,Troy Calhoun,892500,26500,919000,255000,123750
125,Air Force,Mt. West,2014,Troy Calhoun,866250,26500,892750,247500,0
125,Air Force,Mt. West,2013,Troy Calhoun,882000,21100,903100,247500,0
125,Air Force,Mt. West,2012,Troy Calhoun,882000,0,882000,247000,0
125,Air Force,Mt. West,2011,Troy Calhoun,866250,22845,889095,247500,0
125,Air Force,Mt. West,2010,Troy Calhoun,725000,18500,743500,580000,0
125,Air Force,Mt. West,2009,Troy Calhoun,760000,16500,776500,217500,0
125,Air Force,Mt. West,2007,Troy Calhoun,550000,21500,571500,125000,0
125,Air Force,Mt. West,2006,Fisher DeBerry,755370,0,755370,154000,0
126,Brigham Young,Ind.,2018,Kalani Sitake,0,0,0,0,0
126,Brigham Young,Ind.,2017,Kalani Sitake,0,0,0,0,0
126,Brigham Young,Ind.,2016,Kalani Sitake,0,0,0,0,0
126,Brigham Young,Ind.,2015,Bronco Mendenhall,0,0,0,0,0
126,Brigham Young,Ind.,2014,Bronco Mendenhall,0,0,0,0,0
126,Brigham Young,Ind.,2013,Bronco Mendenhall,0,0,0,0,0
126,Brigham Young,Ind.,2012,Bronco Mendenhall,0,0,0,0,0
126,Brigham Young,Ind.,2011,Bronco Mendenhall,0,0,0,0,0
126,Brigham Young,Ind.,2010,Bronco Mendenhall,0,0,0,0,0
126,Brigham Young,Ind.,2009,Bronco Mendenhall,0,0,0,0,0
126,Brigham Young,Ind.,2007,Bronco Mendenhall,0,0,0,0,0
126,Brigham Young,Ind.,2006,Bronco Mendenhall,0,0,0,0,0
127,Rice,C-USA,2018,Mike Bloomgren,0,0,0,0,0
127,Rice,C-USA,2017,David Bailiff,772883,0,772883,0,0
127,Rice,C-USA,2016,David Bailiff,903556,0,903556,0,0
127,Rice,C-USA,2015,David Bailiff,805088,0,805088,0,0
127,Rice,C-USA,2014,David Bailiff,780243,0,780243,0,0
127,Rice,C-USA,2013,David Bailiff,646386,0,646386,0,0
127,Rice,C-USA,2012,David Bailiff,608846,0,608846,0,0
127,Rice,C-USA,2011,David Bailiff,625001,0,625001,0,0
127,Rice,C-USA,2010,David Bailiff,487340,0,487340,0,0
127,Rice,C-USA,2009,David Bailiff,476842,0,476842,0,0
127,Rice,C-USA,2007,David Bailiff,0,0,0,0,0
127,Rice,C-USA,2006,Todd Graham,0,0,0,0,0
128,Temple,AAC,2018,Geoff Collins,0,0,0,0,0
128,Temple,AAC,2017,Geoff Collins,0,0,0,0,0
128,Temple,AAC,2016,Matt Rhule,1041739,0,1041739,0,0
128,Temple,AAC,2015,Matt Rhule,648633,0,648633,0,0
128,Temple,AAC,2014,Matt Rhule,0,0,0,0,0
128,Temple,AAC,2013,Matt Rhule,0,0,0,0,0
128,Temple,AAC,2012,Steve Addazio,0,0,0,0,0
128,Temple,AAC,2011,Steve Addazio,0,0,0,0,0
128,Temple,AAC,2010,Al Golden,513867,0,513867,0,0
128,Temple,AAC,2009,Al Golden,505000,0,505000,0,0
128,Temple,AAC,2007,Al Golden,0,0,0,0,0
128,Temple,AAC,2006,Al Golden,0,0,0,0,0
129,Southern Methodist,AAC,2018,Sonny Dykes,0,0,0,0,0
129,Southern Methodist,AAC,2017,Chad Morris,2095793,0,2095793,0,0
129,Southern Methodist,AAC,2016,Chad Morris,0,0,0,0,0
129,Southern Methodist,AAC,2015,Chad Morris,0,0,0,0,0
129,Southern Methodist,AAC,2014,June Jones,2019718,0,2019718,0,0
129,Southern Methodist,AAC,2013,June Jones,1911511,0,1911511,0,0
129,Southern Methodist,AAC,2012,June Jones,1825089,0,1825089,0,0
129,Southern Methodist,AAC,2011,June Jones,1727082,0,1727082,0,0
129,Southern Methodist,AAC,2010,June Jones,2142056,0,2142056,0,0
129,Southern Methodist,AAC,2009,June Jones,1206368,0,1206368,0,0
129,Southern Methodist,AAC,2007,Phil Bennett,517857,0,517857,0,0
129,Southern Methodist,AAC,2006,Phil Bennett,495602,0,495602,0,0
17,Iowa,Big Ten,2018,Kirk Ferentz,4700000,0,4700000,2875000,600000
17,Iowa,Big Ten,2017,Kirk Ferentz,4550000,0,4550000,2875000,600000
17,Iowa,Big Ten,2016,Kirk Ferentz,4500000,0,4500000,2875000,900000
17,Iowa,Big Ten,2015,Kirk Ferentz,4075000,0,4075000,2375000,25000
17,Iowa,Big Ten,2014,Kirk Ferentz,4075000,0,4075000,1750000,0
17,Iowa,Big Ten,2013,Kirk Ferentz,3985000,0,3985000,1750000,0
17,Iowa,Big Ten,2012,Kirk Ferentz,3835000,0,3835000,1750000,0
17,Iowa,Big Ten,2011,Kirk Ferentz,3785000,0,3785000,1750000,0
17,Iowa,Big Ten,2010,Kirk Ferentz,3775000,6000,3781000,1750000,0
17,Iowa,Big Ten,2009,Kirk Ferentz,3020000,4500,3024500,1000000,0
17,Iowa,Big Ten,2007,Kirk Ferentz,3020000,10000,3030000,1000000,0
17,Iowa,Big Ten,2006,Kirk Ferentz,2840000,0,2840000,1000000,0
36,LSU,SEC,2018,Ed Orgeron,3500000,0,3500000,1575000,100000
36,LSU,SEC,2017,Ed Orgeron,3500000,0,3500000,1575000,25000
36,LSU,SEC,2016,Les Miles,4300000,85567,4385567,700000,100000
36,LSU,SEC,2015,Les Miles,4300000,88721,4388721,700000,100000
36,LSU,SEC,2014,Les Miles,4300000,69582,4369582,700000,0
36,LSU,SEC,2013,Les Miles,4300000,159363,4459363,700000,0
36,LSU,SEC,2012,Les Miles,3751000,105417,3856417,700000,0
36,LSU,SEC,2011,Les Miles,3751000,105417,3856417,700000,0
36,LSU,SEC,2010,Les Miles,3751000,154000,3905000,400000,0
36,LSU,SEC,2009,Les Miles,300000,3451000,3751000,650000,0
36,LSU,SEC,2007,Les Miles,850000,966000,1816000,525000,0
36,LSU,SEC,2006,Les Miles,500000,950000,1450000,450000,0
130,Army,Ind.,2018,Jeff Monken,0,0,0,0,0
130,Army,Ind.,2017,Jeff Monken,0,0,0,0,0
130,Army,Ind.,2016,Jeff Monken,932521,0,932521,256000,0
130,Army,Ind.,2015,Jeff Monken,883000,0,883000,256000,0
130,Army,Ind.,2014,Jeff Monken,834667,0,834667,256000,0
130,Army,Ind.,2013,Rich Ellerson,401500,0,401500,550000,0
130,Army,Ind.,2012,Rich Ellerson,600000,0,600000,350000,0
130,Army,Ind.,2011,Rich Ellerson,610000,0,610000,350000,0
130,Army,Ind.,2010,Rich Ellerson,400000,0,400000,550000,0
130,Army,Ind.,2009,Rich Ellerson,200000,200000,400000,450000,0
130,Army,Ind.,2007,Stan Brock,0,0,0,0,0
130,Army,Ind.,2006,Bobby Ross,0,0,0,0,0
